"Welcome to the world of wishes", an ominous voice calls from afar. You stirr in your sleep and wake up, only to find yourself on cold grass - you don't remember falling asleep here. You look around you, only to realize you are in the midst of a forest clearing. It's horribly foggy, but strangely warm.

WishFish
An Interactive Fiction by Elena Krzina
Release 1 / Serial number 230108 / Inform 7 build 6M62 (I6/v6.33 lib 6/12N) SD

Clearing
It's dark and foggy, so you don't see much. There's dark grass bluish in color from the light emitted by the few fireflies swirling around you. Trees as far and wide as the eye can see. There's an old sign here.

>look
Clearing
It's dark and foggy, so you don't see much. There's dark grass bluish in color from the light emitted by the few fireflies swirling around you. Trees as far and wide as the eye can see. There's an old sign here.

>n
Treestump
A large treestump is lying vertically on the ground of the clearing. A few toadstools sit around it, acting as lamps.

You can see a flashlight, a mirror and a fishhook here.

>look at flashlight
As you inspect the flashlight, you see that it is fully functional and can be turned on and off without problems. It flickers a bit, but it should have enough battery to use it for a few minutes at worst.

>look
Treestump
A large treestump is lying vertically on the ground of the clearing. A few toadstools sit around it, acting as lamps.

You can see a flashlight, a mirror and a fishhook here.

>show
What do you want to show yourself?

>flashlight
(to yourself)
(first taking the flashlight)
Upon taking the flashlight, the other items magically disappear... You decide to go back.

Clearing
It's dark and foggy, so you don't see much. There's dark grass bluish in color from the light emitted by the few fireflies swirling around you. Trees as far and wide as the eye can see. There's an old sign here.

* * *

>remember what happened
When you try to remember what happened, you suddenly get very dizzy. Nothing comes to mind, however.

>catch fish
You can't see any such thing.

>s
First path
As you move deeper into the forest, you can see a tree-lined path that splits left and right. There is a carving in the middle of a giant tree, barely noticeable.

>w
Dreams
You find yourself in another clearing of the forest, but the trees around you appear to be violet in color. There is a clear stream in the middle of the clearing through which busy colorful fish swim. Small dragonflowers swaying in the trees emit a gentle light.

You can see Weeping Blue and a horned rabbit here.

* * *

>look
Dreams
You find yourself in another clearing of the forest, but the trees around you appear to be violet in color. There is a clear stream in the middle of the clearing through which busy colorful fish swim. Small dragonflowers swaying in the trees emit a gentle light.

You can see Weeping Blue and a horned rabbit here.

>catch horned rabbit
You run after the horned rabbit and it starts fleeing. You follow the rabbit out of the clearing, landing in a new area.

Town Square

>n
You can't go that way.

>w
You can't go that way.

>e
You can't go that way.

>s
You can't go that way.

* * *

>check yourself
You check yourself. Your clothes are a bit dirty and you can count a few bruises up your arms, but nothing more that that.

* * *

>sleep
You aren't feeling especially drowsy.

* * *

>look at sign
On the sign, you can make out faded words made with black oil paint. It says "Go north. Choose one. Go south. Choose any."

>n
Treestump
A large treestump is lying vertically on the ground of the clearing. A few toadstools sit around it, acting as lamps.

You can see a flashlight, a mirror and a fishhook here.

>look at mirror
The mirror is cracked in the middle, but it still serves its purpose of reflecting images. You know what they say about cracked mirrors, but you're feeling lucky today.

>take mirror
Upon taking the cracked mirror, the other items magically disappear... You decide to go back.

Clearing
It's dark, so you don't see much. There's dark grass bluish in color from the light emitted by the few fireflies swirling around you. Trees as far and wide as the eye can see.

You can see an old sign here.

>n
You have all the items you could get. Time to move on.

>s
First path
As you move deeper into the forest, you can see a tree-lined path that splits left and right. There is a carving in the middle of a giant tree, barely noticeable.

>look at carving
"Have your dreams come true", is written under the left arrow. A bit optimistic, and since you're not sure yourself whether this location is a dream on its own, you're not too excited. On the other hand, the right sign says "The end of all", which is kind of threatening, and your feet refuse to move.

>w
Dreams
You find yourself in another clearing of the forest, but the trees around you appear to be violet in color. There is a clear stream in the middle of the clearing through which busy colorful fish swim. Small dragonflowers swaying in the trees emit a gentle light.

You can see Weeping Blue and a horned rabbit here.

>look at weeping blue
A blue-colored woman whose hair is a the color and shine of crystals with a beautiful necklace around her neck.She is weeping silently.

>ask weeping blue about what happened
Weeping Blue:  I've been here for so long, I have forgotten how my face looks. And the stream is filled with fish, and I don't look like a fish, I know that much!

>jump into water
You must supply a noun.

* * *

>look at old sign
On the sign, you can make out faded words made with black oil paint. It says "Go north. Choose one. Go south. Choose any."

>go n
treestump
A large treestump is lying vertically on the ground of the clearing. A few toadstools sit around it, acting as lamps.

You can see a flashlight, a cracked mirror and a fishhook here.

>look
treestump
A large treestump is lying vertically on the ground of the clearing. A few toadstools sit around it, acting as lamps.

* * *

>go n
treestump
A large treestump is lying vertically on the ground of the clearing. A few toadstools sit around it, acting as lamps.

You can see a flashlight, a cracked mirror and a fishhook here.

>take cracked mirror
Upon taking the cracked mirror, the other items magically disappear... You decide to go back.

clearing
It's dark, so you don't see much. There's dark grass bluish in color from the light emitted by the few fireflies swirling around you. Trees as far and wide as the eye can see.

You can see an old sign here.

>look at cracked mirror
The mirror is cracked in the middle, but it still serves its purpose of reflecting images. You know what they say about cracked mirrors, but you're feeling lucky today.

>go n
You have all the items you could get. Time to move on.

treestump
A large treestump is lying vertically on the ground of the clearing. A few toadstools sit around it, acting as lamps.

You can see a flashlight and a fishhook here.

* * *

>go n
Treestump
A large treestump is lying vertically on the ground of the clearing. A few toadstools sit around it, acting as lamps.

You can see a flashlight, a mirror and a fishhook here.

>look at old flashlight
As you inspect the flashlight, you see that it is fully functional and can be turned on and off without problems. It flickers a bit, but it should have enough battery to use it for a few minutes at worst.

>inventory
You are carrying nothing.

>look at cracked mirror
The mirror is cracked in the middle, but it still serves its purpose of reflecting images. You know what they say about cracked mirrors, but you're feeling lucky today.

>look at single fishhook
A single fishook that isn't attached to anything. It's strange to see a fishhook not attached to a pole. You're a fisherman's son, so you know much about the art, and even a small hook could perhaps help you later.

* * *

>go n
Treestump
A large treestump is lying vertically on the ground of the clearing. A few toadstools sit around it, acting as lamps.

You can see a flashlight, a mirror and a fishhook here.

>go s
clearing
It's dark, so you don't see much. There's dark grass bluish in color from the light emitted by the few fireflies swirling around you. Trees as far and wide as the eye can see.

You can see an old sign here.

>go n
treestump
A large treestump is lying vertically on the ground of the clearing. A few toadstools sit around it, acting as lamps.

You can see an old flashlight, a cracked mirror and a single fishhook here.

>take old flashlight
Upon taking the flashlight, the other items magically disappear
clearing
It's dark, so you don't see much. There's dark grass bluish in color from the light emitted by the few fireflies swirling around you. Trees as far and wide as the eye can see.

You can see an old sign here.

>go n
treestump
A large treestump is lying vertically on the ground of the clearing. A few toadstools sit around it, acting as lamps.

You can see a cracked mirror and a single fishhook here.

>inventory
You are carrying:
  an old flashlight

* * *

>go n
Treestump
A large treestump is lying vertically on the ground of the clearing. A few toadstools sit around it, acting as lamps.

You can see a flashlight, a mirror and a fishhook here.

>take old flashlight
Upon taking the flashlight, the other items magically disappear... You decide to go back.

clearing
It's dark, so you don't see much. There's dark grass bluish in color from the light emitted by the few fireflies swirling around you. Trees as far and wide as the eye can see.

You can see an old sign here.

>go n
treestump
A large treestump is lying vertically on the ground of the clearing. A few toadstools sit around it, acting as lamps.

You can see a cracked mirror and a single fishhook here.

>go s
clearing
It's dark, so you don't see much. There's dark grass bluish in color from the light emitted by the few fireflies swirling around you. Trees as far and wide as the eye can see.

You can see an old sign here.

>go n
treestump
A large treestump is lying vertically on the ground of the clearing. A few toadstools sit around it, acting as lamps.

You can see a cracked mirror and a single fishhook here.

* * *

>go n
Treestump
A large treestump is lying vertically on the ground of the clearing. A few toadstools sit around it, acting as lamps.

You can see a flashlight, a mirror and a fishhook here.

>take flashlight
Upon taking the flashlight, the other items magically disappear... You decide to go back.

clearing
It's dark, so you don't see much. There's dark grass bluish in color from the light emitted by the few fireflies swirling around you. Trees as far and wide as the eye can see.

You can see an old sign here.

>go n
You have all the items you could get. Time to move on.

>go n
You have all the items you could get. Time to move on.

>look
clearing
It's dark, so you don't see much. There's dark grass bluish in color from the light emitted by the few fireflies swirling around you. Trees as far and wide as the eye can see.

You can see an old sign here.

* * *

>go n
Treestump
A large treestump is lying vertically on the ground of the clearing. A few toadstools sit around it, acting as lamps.

You can see a flashlight, a mirror and a fishhook here.

>take fishhook
Upon taking the hook, the other items magically disappear... You decide to go back.

Clearing
It's dark, so you don't see much. There's dark grass bluish in color from the light emitted by the few fireflies swirling around you. Trees as far and wide as the eye can see.

You can see an old sign here.

>go n
You have all the items you could get. Time to move on.

* * *

>look
clearing
It's dark, so you don't see much. There's dark grass bluish in color from the light emitted by the few fireflies swirling around you. Trees as far and wide as the eye can see.

You can see an old sign here.

>inventory
You are carrying:
  a fishhook

>go n
You have all the items you could get. Time to move on.

>remember what happened
When you try to remember what happened, you suddenly get very dizzy. Nothing comes to mind, however.

>check yourself
You check yourself. Your clothes are a bit dirty and you can count a few bruises up your arms, but nothing more that that. Same old, same old.

* * *

>go n
You have all the items you could get. Time to move on.

>go s
First path
As you move deeper into the forest, you can see a tree-lined path that splits left and right. There is a carving in the middle of a giant tree, barely noticeable.

>look at carving
"Have your dreams come true", is written under the left arrow. A bit optimistic, and since you're not sure yourself whether this location is a dream on its own, you're not too excited. On the other hand, the right sign says "The end of all", which is kind of threatening, and your feet refuse to move.

* * *

>go n
Treestump
A large treestump is lying vertically on the ground of the clearing. A few toadstools sit around it, acting as lamps.

You can see a flashlight, a mirror and a fishhook here.

>take cracked mirror
Upon taking the cracked mirror, the other items magically disappear... You decide to go back.

clearing
It's dark, so you don't see much. There's dark grass bluish in color from the light emitted by the few fireflies swirling around you. Trees as far and wide as the eye can see.

You can see an old sign here.

>go n
treestump
A large treestump is lying vertically on the ground of the clearing. A few toadstools sit around it, acting as lamps.

You can see a cracked mirror and a fishhook here.

* * *

>go n
Treestump
A large treestump is lying vertically on the ground of the clearing. A few toadstools sit around it, acting as lamps.

You can see a flashlight, a mirror and a fishhook here.

>take mirror
Upon taking the cracked mirror, the other items magically disappear... You decide to go back.

clearing
It's dark, so you don't see much. There's dark grass bluish in color from the light emitted by the few fireflies swirling around you. Trees as far and wide as the eye can see.

You can see an old sign here.

>go n
You have all the items you could get. Time to move on.

>take fishhook
Upon taking the hook, the other items magically disappear... You decide to go back.

clearing
It's dark, so you don't see much. There's dark grass bluish in color from the light emitted by the few fireflies swirling around you. Trees as far and wide as the eye can see.

You can see an old sign here.

>go n
You have all the items you could get. Time to move on.
You have all the items you could get. Time to move on.

* * *

>go n
You have all the items you could get. Time to move on.

>inventory
You are carrying:
  a mirror

* * *

>go n
You have all the items you could get. Time to move on.

>look at old sign
On the sign, you can make out faded words made with black oil paint. It says "Go north. Choose one. Go south. Choose any."

>go south
First path
As you move deeper into the forest, you can see a tree-lined path that splits left and right.

>look
First path
As you move deeper into the forest, you can see a tree-lined path that splits left and right.

>look at carved tree
There is a carving in the middle of a tree, barely noticeable. "Have your dreams come true", is written under the left arrow. A bit optimistic, and since you're not sure yourself whether this location is a dream on its own, you're not too excited. On the other hand, the right sign says "The end of all", which is kind of threatening, and your feet refuse to move.

* * *

>take fishhook
You can't see any such thing.

>go n
treestump
A large treestump is lying vertically on the ground of the clearing. A few toadstools sit around it, acting as lamps.

You can see a flashlight, a mirror and a fishhook here.

>take fishhook
Upon taking the hook, the other items magically disappear... You decide to go back.

clearing
It's dark, so you don't see much. There's dark grass bluish in color from the light emitted by the few fireflies swirling around you. Trees as far and wide as the eye can see.

You can see an old sign here.

>go n
treestump
A large treestump is lying vertically on the ground of the clearing. A few toadstools sit around it, acting as lamps.

You can see a flashlight and a mirror here.

* * *

>go s
First path
As you move deeper into the forest, you can see a tree-lined path that splits left and right. There is a carving in the middle of a giant tree, barely noticeable.

>look at tree carving
You can't see any such thing.

>look at carved tree
"Have your dreams come true", is written under the left arrow. A bit optimistic, and since you're not sure yourself whether this location is a dream on its own, you're not too excited. On the other hand, the right sign says "The end of all", which is kind of threatening, and your feet refuse to move.

* * *

>look at carving
"Have your dreams come true", is written under the left arrow. A bit optimistic, and since you're not sure yourself whether this location is a dream on its own, you're not too excited. On the other hand, the right sign says "The end of all", which is kind of threatening, and your feet refuse to move.

>go n
clearing
It's dark, so you don't see much. There's dark grass bluish in color from the light emitted by the few fireflies swirling around you. Trees as far and wide as the eye can see.

You can see an old sign here.

* * *

>go s
First path
As you move deeper into the forest, you can see a tree-lined path that splits left and right. There is a carving in the middle of a giant tree, barely noticeable.

>go w
Dreams
You find yourself in another clearing of the forest, but the trees around you appear to be violet in color. There is a clear stream in the middle of the clearing through which busy colorful fish swim. Small dragonflowers swaying in the trees emit a gentle light.

You can see Weeping Blue and Horned rabbit here.

* * *

>go s
First path
As you move deeper into the forest, you can see a tree-lined path that splits left and right. There is a carving in the middle of a giant tree, barely noticeable.

>w
Dreams
You find yourself in another clearing of the forest, but the trees around you appear to be violet in color. There is a clear stream in the middle of the clearing through which busy colorful fish swim. Small dragonflowers swaying in the trees emit a gentle light.

You can see Weeping Blue and a horned rabbit here.

>e
First path
As you move deeper into the forest, you can see a tree-lined path that splits left and right. There is a carving in the middle of a giant tree, barely noticeable.

>w
Dreams
You find yourself in another clearing of the forest, but the trees around you appear to be violet in color. There is a clear stream in the middle of the clearing through which busy colorful fish swim. Small dragonflowers swaying in the trees emit a gentle light.

You can see Weeping Blue and a horned rabbit here.

* * *

>e
First path
As you move deeper into the forest, you can see a tree-lined path that splits left and right. There is a carving in the middle of a giant tree, barely noticeable.

>n
Clearing
It's dark, so you don't see much. There's dark grass bluish in color from the light emitted by the few fireflies swirling around you. Trees as far and wide as the eye can see.

You can see an old sign here.

>n
Treestump
A large treestump is lying vertically on the ground of the clearing. A few toadstools sit around it, acting as lamps.

You can see a flashlight, a mirror and a fishhook here.

>take mirror
Upon taking the cracked mirror, the other items magically disappear... You decide to go back.

Clearing
It's dark, so you don't see much. There's dark grass bluish in color from the light emitted by the few fireflies swirling around you. Trees as far and wide as the eye can see.

You can see an old sign here.

>s
First path
As you move deeper into the forest, you can see a tree-lined path that splits left and right. There is a carving in the middle of a giant tree, barely noticeable.

* * *

>w
Dreams
You find yourself in another clearing of the forest, but the trees around you appear to be violet in color. There is a clear stream in the middle of the clearing through which busy colorful fish swim. Small dragonflowers swaying in the trees emit a gentle light.

You can see Weeping Blue and a horned rabbit here.

>show mirror to weeping blue
Weeping Blue is unimpressed.

>show mirror to horned rabbit
The horned rabbit is unimpressed.

>show mirror to fish
You can only do that to something animate.

>give mirror to wwping blue
You can't see any such thing.

>give mirror to weeping blue
Weeping Blue doesn't seem interested.

* * *

>n
Treestump
A large treestump is lying vertically on the ground of the clearing. A few toadstools sit around it, acting as lamps.

You can see a flashlight, a mirror and a fishhook here.

>s
Clearing
It's dark and foggy, so you don't see much. There's dark grass bluish in color from the light emitted by the few fireflies swirling around you. Trees as far and wide as the eye can see.

You can see an old sign here.

>read sign
On the sign, you can make out faded words made with black oil paint. It says "Go north. Choose one. Go south. Choose any. 0"

* * *

>s
Clearing
It's dark and foggy, so you don't see much. There's dark grass bluish in color from the light emitted by the few fireflies swirling around you. Trees as far and wide as the eye can see.

You can see an old sign here.

>s
First path
As you move deeper into the forest, you can see a tree-lined path that splits left and right. There is a carving in the middle of a giant tree, barely noticeable.

* * *

>w
Dreams
You find yourself in another clearing of the forest, but the trees around you appear to be violet in color. There is a clear stream in the middle of the clearing through which busy colorful fish swim. Small dragonflowers swaying in the trees emit a gentle light.

You can see Weeping Blue and a horned rabbit here.

>s
Town Square
You can see Old lady, Gentleman, Curious girl, Nutcracker, Fisherman, Polly and a purse here.

>play rock for polly
PAPER!
You lose! You lose!

>play rock for polly
SCISSORS!
I lost?!
Polly gives you a gem.

>check gems
You currently have 1 gems.

* * *

>n
Treestump
A large treestump is lying vertically on the ground of the clearing. A few toadstools sit around it, acting as lamps.

You can see a flashlight, a mirror and a fishhook here.

>take mirror
Upon taking the cracked mirror, the other items magically disappear... You decide to go back.

Clearing
It's dark and foggy, so you don't see much. There's dark grass bluish in color from the light emitted by the few fireflies swirling around you. Trees as far and wide as the eye can see. There's an old sign here.

>s
Diverging path
As you move deeper into the forest, you can see a tree-lined path that splits left and right. There is a carving in the middle of a giant tree, barely noticeable.

>w
Dreams
You find yourself in another clearing of the forest, but the trees around you appear to be violet in color. There is a clear stream in the middle of the clearing through which busy colorful fish swim. Small dragonflowers swaying in the trees emit a gentle light.

You can see Weeping Blue and a horned rabbit here.

>show mirror to weeping blue
Weeping Blue takes the cracked mirror from your hands and looks at herself. She suddenly smiles a brilliant smile.
Thank you very much, boy. I finally remember how I look like.
In the back, the horned rabbit's eyes shine.

>inventory
You are carrying:
  a mirror

* * *

>show mirror to weeping blue
Weeping Blue takes the cracked mirror from your hands and looks at herself. She suddenly smiles a brilliant smile.
Thank you very much, boy. I finally remember how I look like.
In the back, the horned rabbit's eyes shine.

>show mirror to horned rabbit
The horned rabbit is unimpressed.

>show mirror
Whom do you want to show the mirror to?

>weeping blue
Weeping Blue is unimpressed.

>give mirror
Whom do you want to give the mirror to?

>weeping blue
Weeping Blue doesn't seem interested.

* * *

>show mirror to weeping blue
Weeping Blue takes the cracked mirror from your hands and looks at herself. She suddenly smiles a brilliant smile.
Thank you very much, boy. I finally remember how I look like.
In the back, the horned rabbit's eyes shine.

>look at horned rabbit
A white horned rabbit, curiously looking your way. No matter what you do, it seems intent on following. Try approaching it!

>approach horned rabbit
The rabbit seems pleased with you that you've taken the time to help the woman out of her troubles. He wants you to follow him south, while shaking 50 gems out of its furr. You obtain the gems, and follow him wordlessly.

Town Square
A large clearing in the forest populated by dozens of wooden houses giving off a cozy feeling. There's solid ground underneath your feet, and a large ceiling above your head. You can't make out the material it's made out of. There's large streetlamps to illuminate the path and a large fountain of clear water in the middle. Children are dnacing in a circle in the bag, a cat is meowing from a roof. People walk around, chat, look at you as you stand at the entrance. An imposing clock tower can be seen from the distance, almost reaching the white round drawing of a moon. The smell of wood and bakeries is overwhelming.

You can see Old lady, Gentleman, Lotty, Nutcracker, Fisherman, Polly and a purse here.

* * *

>show mirror to weeping blue
Weeping Blue takes the cracked mirror from your hands and looks at herself. She suddenly smiles a brilliant smile.
Thank you very much, boy. I finally remember how I look like.
In the back, the horned rabbit's eyes shine.

>approach rabbit
The rabbit seems pleased with you that you've taken the time to help the woman out of her troubles. He wants you to follow him south, while shaking 50 gems out of its furr. You obtain the gems, and follow him wordlessly.

Town Square
A large clearing in the forest populated by dozens of wooden houses giving off a cozy feeling. There's solid ground underneath your feet, and a large ceiling above your head. You can't make out the material it's made out of. There's large streetlamps to illuminate the path and a large fountain of clear water in the middle. Children are dnacing in a circle in the bag, a cat is meowing from a roof. People walk around, chat, look at you as you stand at the entrance. An imposing clock tower can be seen from the distance, almost reaching the yellow round drawing of a moon. The smell of wood and bakeries is overwhelming.

You can see Old lady, Gentleman, Lotty, Nutcracker, Fisherman, Polly and a purse here.

>ask fisherman about him
There is no reply.

>ask fisherman about what he is doing
Fisherman: I'm tryin" to attach this hook to my pole, but I'm afraid these hands aren't as deft as they used to be.
The man struggles to attach the hook onto his pole. His ham hands can't quite make a tie as small as that.

>help fisherman tie hook
You tie the fisherman's hook to the pole with a smile. The fisherman gives you 20 gems as compensation, which you politely decline. But the fisherman stuffs them into your hand nevertheless.

>w
Tree-lined Path
A silent path. A few owls sit on the birch trees leading to the town square. The ceiling you've seen in the town square is nowhere to be seen, a thick white blanket covering the sky instead.

>w
Calm Pond
A small pond, perfectly still. The sky is covered in white, unmoving clouds. There is a wooden platform next to the north of here. You see a young man sitting on said platform in the distance.

You can see a bucket here.

>w
Yard
A small yard leading to a cozy wooden tavern just west of here.

You can see Large Bear here.

>w
Tavern
A lively place. A live band is performing is in the back, and dozens of people are gathered at tiny coffee tables, enjoying hot beverages.

You can see a black tea, chamomile tea, a slippery elm tea, Lars, Snowman, Dan, Ginny, Bugcatcher and Schoolteacher here.

>ask lars about making tea
Lars: Here you go.
Obtained hot tea.

>e
Yard
A small yard leading to a cozy wooden tavern just west of here.

You can see Large Bear here.

>e
Calm Pond
A small pond, perfectly still. The sky is covered in white, unmoving clouds. There is a wooden platform next to the north of here. You see a young man sitting on said platform in the distance.

You can see a bucket here.

>e
Tree-lined Path
A silent path. A few owls sit on the birch trees leading to the town square. The ceiling you've seen in the town square is nowhere to be seen, a thick white blanket covering the sky instead.

>e
Town Square
A large clearing in the forest populated by dozens of wooden houses giving off a cozy feeling. There's solid ground underneath your feet, and a large ceiling above your head. You can't make out the material it's made out of. There's large streetlamps to illuminate the path and a large fountain of clear water in the middle. Children are dnacing in a circle in the bag, a cat is meowing from a roof. People walk around, chat, look at you as you stand at the entrance. An imposing clock tower can be seen from the distance, almost reaching the white round drawing of a moon. The smell of wood and bakeries is overwhelming.

You can see Old lady, Gentleman, Lotty, Nutcracker, Fisherman, Polly and a purse here.

>e
Clock Tower
An ancient clock tower, made with brown stone and covered in ivies that climbed its walls for ages. Its tower reaches well into the man-made ceiling, the tip of it nearly touching the yellow drawing of the inexistant moon of this world. The hands of time seem to flow seamlessly into the wrong side. As you enter the building, you're met with an owl guard whose head turns into your diretion as your first footsteps echo through the marble-covered floor. To the west, you see a staircase that leads up the slim tower, seemingly leading into a circle as you climb the building. To the south, there is a dark entrance, something shining gleaming from behind it.

You can see Owl here.

>temporal hoot
The owl's eyes widen and it hoots. The clock behind it shows time ticking in the right direction again.

>s
Treasury
A large open room filled with the brim with gold coins and gems. A large dragon sleeps on top of it all, snoring contently. There's a worn sign here.

>deposit gems
You don't think that'll be enough.

>check gems
You currently have 60 gems.

>w
You can't go that way.

>w
You can't go that way.

>n
Clock Tower
An ancient clock tower, made with brown stone and covered in ivies that climbed its walls for ages. Its tower reaches well into the man-made ceiling, the tip of it nearly touching the yellow drawing of the inexistant moon of this world. The hands of time seem to flow seamlessly into the wrong side. As you enter the building, you're met with an owl guard whose head turns into your diretion as your first footsteps echo through the marble-covered floor. To the west, you see a staircase that leads up the slim tower, seemingly leading into a circle as you climb the building. To the south, there is a dark entrance, something shining gleaming from behind it.

You can see Owl here.

>w
Bell Tower
The climb up the stairs is arduous and dizzying. Something doesn't feel quite right as you ascend the endless tower. But then you exit, and a gust of harsh wind blows into your face. You find yourself at the top of the tower, right below the glowing painted moon. In front of you, there is a giant bell, filled with ancient reliefs and jewels, just ready to be rung. A fierce dragon stands in front of it protectively, asserting your intentions.

>e
Clock Tower
An ancient clock tower, made with brown stone and covered in ivies that climbed its walls for ages. Its tower reaches well into the man-made ceiling, the tip of it nearly touching the yellow drawing of the inexistant moon of this world. The hands of time seem to flow seamlessly into the wrong side. As you enter the building, you're met with an owl guard whose head turns into your diretion as your first footsteps echo through the marble-covered floor. To the west, you see a staircase that leads up the slim tower, seemingly leading into a circle as you climb the building. To the south, there is a dark entrance, something shining gleaming from behind it.

You can see Owl here.

>e
You can't go that way.

* * *

>take purse
Before you could pick up the purse, the gentleman wearing that ridiculously large tophat you saw at the entrance stops you and bows to you.
Gentleman: What are you doing, young sir? You are in no way entitled to this woman's purse. Run along, now.
You decide to leave the purse where it is.

>help fisherman tie hook
You tie the fisherman's hook to the pole with a smile. The fisherman gives you 20 gems as compensation, which you politely decline. But the fisherman stuffs them into your hand nevertheless.

* * *

>w
Calm Pond
A small pond, perfectly still. The sky is covered in white, unmoving clouds. There is a wooden platform next to the north of here. You see a young man sitting on said platform in the distance.

You can see a bucket here.

I beg your pardon?

>w
Yard
A small yard leading to a cozy wooden tavern just west of here.

You can see Large Bear here.

* * *

>give hot tea to gentleman
The gentleman wordlessly takes the cup of tea and goes to sit at the fountain to drink.

>e
Clock Tower
An ancient clock tower, made with brown stone and covered in ivies that climbed its walls for ages. Its tower reaches well into the man-made ceiling, the tip of it nearly touching the yellow drawing of the inexistant moon of this world. The hands of time seem to flow seamlessly into the wrong side. As you enter the building, you're met with an owl guard whose head turns into your diretion as your first footsteps echo through the marble-covered floor. To the north, you see a staircase that leads up the slim tower, seemingly leading into a circle as you climb the building. To the east, there is a dark entrance, something shining gleaming from behind it.

You can see Owl here.

>w
Town Square
A large clearing in the forest populated by dozens of wooden houses giving off a cozy feeling. There's solid ground underneath your feet, and a large ceiling above your head. You can't make out the material it's made out of. There's large streetlamps to illuminate the path and a large fountain of clear water in the middle. Children are dnacing in a circle in the bag, a cat is meowing from a roof. People walk around, chat, look at you as you stand at the entrance. An imposing clock tower can be seen from the distance, almost reaching the white round drawing of a moon. The smell of wood and bakeries is overwhelming.

You can see Old lady, Gentleman, Lotty, Nutcracker, Fisherman, Polly and a purse here.

>take purse
You take the purse.

>reach into purse
You reach into the purse. There's 50 gems in it. You take them with you.

>reach into purse
You reach into the purse. There's 50 gems in it. You take them with you.

>checm gems
That's not a verb I recognise.

>check gems
You currently have 260 gems.

>check gems
You currently have 260 gems.

>reach into purse
You reach into the purse. There's 50 gems in it. You take them with you.

>check gems
You currently have 310 gems.

>e
Clock Tower
An ancient clock tower, made with brown stone and covered in ivies that climbed its walls for ages. Its tower reaches well into the man-made ceiling, the tip of it nearly touching the yellow drawing of the inexistant moon of this world. The hands of time seem to flow seamlessly into the wrong side. As you enter the building, you're met with an owl guard whose head turns into your diretion as your first footsteps echo through the marble-covered floor. To the north, you see a staircase that leads up the slim tower, seemingly leading into a circle as you climb the building. To the east, there is a dark entrance, something shining gleaming from behind it.

You can see Owl here.

>e
Treasury
A large open room filled with the brim with gold coins and gems. A large dragon sleeps on top of it all, snoring contently. There's a worn sign here.

>deposit gems
You deposited 100 gems for dragon profit.

>w
Clock Tower
An ancient clock tower, made with brown stone and covered in ivies that climbed its walls for ages. Its tower reaches well into the man-made ceiling, the tip of it nearly touching the yellow drawing of the inexistant moon of this world. The hands of time seem to flow seamlessly into the wrong side. As you enter the building, you're met with an owl guard whose head turns into your diretion as your first footsteps echo through the marble-covered floor. To the north, you see a staircase that leads up the slim tower, seemingly leading into a circle as you climb the building. To the east, there is a dark entrance, something shining gleaming from behind it.

You can see Owl here.

>w
Town Square
A large clearing in the forest populated by dozens of wooden houses giving off a cozy feeling. There's solid ground underneath your feet, and a large ceiling above your head. You can't make out the material it's made out of. There's large streetlamps to illuminate the path and a large fountain of clear water in the middle. Children are dnacing in a circle in the bag, a cat is meowing from a roof. People walk around, chat, look at you as you stand at the entrance. An imposing clock tower can be seen from the distance, almost reaching the white round drawing of a moon. The smell of wood and bakeries is overwhelming.

You can see Old lady, Gentleman, Lotty, Nutcracker, Fisherman and Polly here.

>e
Clock Tower
An ancient clock tower, made with brown stone and covered in ivies that climbed its walls for ages. Its tower reaches well into the man-made ceiling, the tip of it nearly touching the yellow drawing of the inexistant moon of this world. The hands of time seem to flow seamlessly into the wrong side. As you enter the building, you're met with an owl guard whose head turns into your diretion as your first footsteps echo through the marble-covered floor. To the north, you see a staircase that leads up the slim tower, seemingly leading into a circle as you climb the building. To the east, there is a dark entrance, something shining gleaming from behind it.

You can see Owl here.

>n
Bell Tower
The climb up the stairs is arduous and dizzying. Something doesn't feel quite right as you ascend the endless tower. But then you exit, and a gust of harsh wind blows into your face. You find yourself at the top of the tower, right below the glowing painted moon. In front of you, there is a giant bell, filled with ancient reliefs and jewels, just ready to be rung. A fierce dragon stands in front of it protectively, asserting your intentions.

>ring bell
You rang the bell. It's soothing sound echoes through the area... Oh? But what's this? Something seems to have fallen out of it as you rung it.
You obtained the shiny key!

>s
Clock Tower
An ancient clock tower, made with brown stone and covered in ivies that climbed its walls for ages. Its tower reaches well into the man-made ceiling, the tip of it nearly touching the yellow drawing of the inexistant moon of this world. The hands of time seem to flow seamlessly into the wrong side. As you enter the building, you're met with an owl guard whose head turns into your diretion as your first footsteps echo through the marble-covered floor. To the north, you see a staircase that leads up the slim tower, seemingly leading into a circle as you climb the building. To the east, there is a dark entrance, something shining gleaming from behind it.

You can see Owl here.

>w
Town Square
A large clearing in the forest populated by dozens of wooden houses giving off a cozy feeling. There's solid ground underneath your feet, and a large ceiling above your head. You can't make out the material it's made out of. There's large streetlamps to illuminate the path and a large fountain of clear water in the middle. Children are dnacing in a circle in the bag, a cat is meowing from a roof. People walk around, chat, look at you as you stand at the entrance. An imposing clock tower can be seen from the distance, almost reaching the white round drawing of a moon. The smell of wood and bakeries is overwhelming.

You can see Old lady, Gentleman, Lotty, Nutcracker, Fisherman and Polly here.

>n
Dreams
You find yourself in another clearing of the forest, but the trees around you appear to be violet in color. There is a clear stream in the middle of the clearing through which busy colorful fish swim. Small dragonflowers swaying in the trees emit a gentle light.

You can see Weeping Blue and a horned rabbit here.

>n
You can't go that way.

>e
Diverging path
As you move deeper into the forest, you can see a tree-lined path that splits left and right. There is a carving in the middle of a giant tree, barely noticeable.

>e
End of All
Your footsteps echo through the small wooden path as if the floor was made of marble instead of leaves. The world around you is starting to feel more and more like a dream, but your tired legs seem to suggest otherwise. There are knights in old black armor standing in front of a giant golden door. The imposing nature of the sight makes you realize this could be the end of the journey.

You can see a golden door, Left Knight and Right Knight here.

>e
(first opening the golden door)
It seems to be locked.

>unlock golden door with shiny ey
I only understood you as far as wanting to unlock the golden door with the shiny key.

>unlock golden door with shiny key
You unlock the golden door.

>e
(first opening the golden door)

fishtank
As you enter the last room, the thing that catches your eyes first is the giant goldfish with a red spot on its forehead, slowly floating in a waterless room as it directs its large eyes towards you. The fish - queen - stares at you for a long time, as if waiting for you to do something.

You can see a golden door here.

>w
End of All
Your footsteps echo through the small wooden path as if the floor was made of marble instead of leaves. The world around you is starting to feel more and more like a dream, but your tired legs seem to suggest otherwise. There are knights in old black armor standing in front of a giant golden door. The imposing nature of the sight makes you realize this could be the end of the journey.

You can see a golden door, Left Knight and Right Knight here.

>e
fishtank
As you enter the last room, the thing that catches your eyes first is the giant goldfish with a red spot on its forehead, slowly floating in a waterless room as it directs its large eyes towards you. The fish - queen - stares at you for a long time, as if waiting for you to do something.

You can see a golden door here.

>w
End of All
Your footsteps echo through the small wooden path as if the floor was made of marble instead of leaves. The world around you is starting to feel more and more like a dream, but your tired legs seem to suggest otherwise. There are knights in old black armor standing in front of a giant golden door. The imposing nature of the sight makes you realize this could be the end of the journey.

You can see a golden door, Left Knight and Right Knight here.

>w
Diverging path
As you move deeper into the forest, you can see a tree-lined path that splits left and right. There is a carving in the middle of a giant tree, barely noticeable.

>w
Dreams
You find yourself in another clearing of the forest, but the trees around you appear to be violet in color. There is a clear stream in the middle of the clearing through which busy colorful fish swim. Small dragonflowers swaying in the trees emit a gentle light.

You can see Weeping Blue and a horned rabbit here.

>w
You can't go that way.

I beg your pardon?

>s
Town Square
A large clearing in the forest populated by dozens of wooden houses giving off a cozy feeling. There's solid ground underneath your feet, and a large ceiling above your head. You can't make out the material it's made out of. There's large streetlamps to illuminate the path and a large fountain of clear water in the middle. Children are dnacing in a circle in the bag, a cat is meowing from a roof. People walk around, chat, look at you as you stand at the entrance. An imposing clock tower can be seen from the distance, almost reaching the white round drawing of a moon. The smell of wood and bakeries is overwhelming.

You can see Old lady, Gentleman, Lotty, Nutcracker, Fisherman and Polly here.

>w
Tree-lined Path
A silent path. A few owls sit on the birch trees leading to the town square. The ceiling you've seen in the town square is nowhere to be seen, a thick white blanket covering the sky instead.

* * *

>w
Yard
A small yard leading to a cozy wooden tavern just west of here.

You can see Large Bear here.

I beg your pardon?

>w
Tavern
A lively place. A live band is performing is in the back, and dozens of people are gathered at tiny coffee tables, enjoying hot beverages.

You can see a black tea, chamomile tea, a slippery elm tea, Lars, Snowman, Dan, Ginny, Bugcatcher and Schoolteacher here.

>take chamomile tea
Taken.

>give chamomile tea to schoolteacher
Schoolteacher: Ah! Most wonderous!
The schoolteacher downs the tea.

>take black tea
Taken.

>give black tea to ginny
Ginny: Yes. That's my order, thank you.

>ask lars about password
You'd like the password, ey? It's quite dangerous to go up the clock tower alone. But let me tell you something - I'm in a good mood today. If you manage to deliver the correct orders, I will reward you with the password.

>take slippery elm tea
Taken.

>give slippery elm ta to dan
You can only do that to something animate.

>give slippery elm tea to dan
Dan: Ah, yes! My order! Thanks! I can continue talking in peace now.

>ask lars about password
Lars: The password is temporary hoot. Also - a bit of a compensation.
Obtained 30 gems!

>check gems
You currently have 240 gems.

* * *

>help fisherman tie hook
You tie the fisherman's hook to the pole with a smile. The fisherman gives you 20 gems as compensation, which you politely decline. But the fisherman stuffs them into your hand nevertheless.

>2
That's not a verb I recognise.

I beg your pardon?

>w
Tree-lined Path
A silent path. A few owls sit on the birch trees leading to the town square. The ceiling you've seen in the town square is nowhere to be seen, a thick white blanket covering the sky instead.

* * *

>w
Tavern
A lively place. A live band is performing is in the back, and dozens of people are gathered at tiny coffee tables, enjoying hot beverages.

You can see a black tea, chamomile tea, a slippery elm tea, Lars, Snowman, Dan, Ginny, Bugcatcher and Schoolteacher here.

>w
You can't go that way.

>ask lars about making tea
Lars: Here you go.
Obtained hot tea.

* * *

>e
Tree-lined Path
A silent path. A few owls sit on the birch trees leading to the town square. The ceiling you've seen in the town square is nowhere to be seen, a thick white blanket covering the sky instead.

>e
Town Square
A large clearing in the forest populated by dozens of wooden houses giving off a cozy feeling. There's solid ground underneath your feet, and a large ceiling above your head. You can't make out the material it's made out of. There's large streetlamps to illuminate the path and a large fountain of clear water in the middle. Children are dnacing in a circle in the bag, a cat is meowing from a roof. People walk around, chat, look at you as you stand at the entrance. An imposing clock tower can be seen from the distance, almost reaching the yellow round drawing of a moon. The smell of wood and bakeries is overwhelming.

You can see Old lady, Gentleman, Lotty, Nutcracker, Fisherman, Polly and a purse here.

>give hot tea to gentleman
The gentleman wordlessly takes the cup of tea and goes to sit at the fountain to drink.

>take purse
You take the purse.

* * *

>reach into purse
You reach into the purse. There's 50 gems in it. You take them with you.

>e
Clock Tower
An ancient clock tower, made with brown stone and covered in ivies that climbed its walls for ages. Its tower reaches well into the man-made ceiling, the tip of it nearly touching the yellow drawing of the inexistant moon of this world. The hands of time seem to flow seamlessly into the wrong side. As you enter the building, you're met with an owl guard whose head turns into your direction as your first footsteps echo through the marble-covered floor. To the north, you see a staircase that leads up the slim tower, seemingly leading into a circle as you climb the building. To the east, there is a dark entrance, something shining gleaming from behind it.

You can see Owl here.

>e
The owl forbids you from entering the chamber. It grabs you and flies out with you!

Town Square
A large clearing in the forest populated by dozens of wooden houses giving off a cozy feeling. There's solid ground underneath your feet, and a large ceiling above your head. You can't make out the material it's made out of. There's large streetlamps to illuminate the path and a large fountain of clear water in the middle. Children are dnacing in a circle in the bag, a cat is meowing from a roof. People walk around, chat, look at you as you stand at the entrance. An imposing clock tower can be seen from the distance, almost reaching the yellow round drawing of a moon. The smell of wood and bakeries is overwhelming.

You can see Old lady, Gentleman, Lotty, Nutcracker, Fisherman and Polly here.

>e
Clock Tower
An ancient clock tower, made with brown stone and covered in ivies that climbed its walls for ages. Its tower reaches well into the man-made ceiling, the tip of it nearly touching the yellow drawing of the inexistant moon of this world. The hands of time seem to flow seamlessly into the wrong side. As you enter the building, you're met with an owl guard whose head turns into your direction as your first footsteps echo through the marble-covered floor. To the north, you see a staircase that leads up the slim tower, seemingly leading into a circle as you climb the building. To the east, there is a dark entrance, something shining gleaming from behind it.

You can see Owl here.

>temporal hoot
The owl's eyes widen and it hoots.

>e
The owl's feathers ruffle, but it remains still.

Treasury
A large open room filled with the brim with gold coins and gems. A monster sleeps on top of it all, snoring contently. There's a note here.

>deposit gems
You deposited 100 gems for dragon profit.

>w
Clock Tower
An ancient clock tower, made with brown stone and covered in ivies that climbed its walls for ages. Its tower reaches well into the man-made ceiling, the tip of it nearly touching the yellow drawing of the inexistant moon of this world. The hands of time seem to flow seamlessly into the wrong side. As you enter the building, you're met with an owl guard whose head turns into your direction as your first footsteps echo through the marble-covered floor. To the north, you see a staircase that leads up the slim tower, seemingly leading into a circle as you climb the building. To the east, there is a dark entrance, something shining gleaming from behind it.

You can see Owl here.

>n
The owl lets you through.

Bell Tower
The climb up the stairs is arduous and dizzying. Something doesn't feel quite right as you ascend the endless tower. But then you exit, and a gust of harsh wind blows into your face. You find yourself at the top of the tower, right below the glowing painted moon. In front of you, there is a giant bell, filled with ancient reliefs and jewels, just ready to be rung. A fierce dragon stands in front of it protectively, asserting your intentions.

>ring bell
The dragon bows its head.
You rang the bell. It's soothing sound echoes through the area... Oh? But what's this? Something seems to have fallen out of it as you rung it.
You obtained the shiny key!

>s
Clock Tower
An ancient clock tower, made with brown stone and covered in ivies that climbed its walls for ages. Its tower reaches well into the man-made ceiling, the tip of it nearly touching the yellow drawing of the inexistant moon of this world. The hands of time seem to flow seamlessly into the wrong side. As you enter the building, you're met with an owl guard whose head turns into your direction as your first footsteps echo through the marble-covered floor. To the north, you see a staircase that leads up the slim tower, seemingly leading into a circle as you climb the building. To the east, there is a dark entrance, something shining gleaming from behind it.

You can see Owl here.

>e
The owl's feathers ruffle, but it remains still.

Treasury
A large open room filled with the brim with gold coins and gems. A monster sleeps on top of it all, snoring contently. There's a note here.

>w
Clock Tower
An ancient clock tower, made with brown stone and covered in ivies that climbed its walls for ages. Its tower reaches well into the man-made ceiling, the tip of it nearly touching the yellow drawing of the inexistant moon of this world. The hands of time seem to flow seamlessly into the wrong side. As you enter the building, you're met with an owl guard whose head turns into your direction as your first footsteps echo through the marble-covered floor. To the north, you see a staircase that leads up the slim tower, seemingly leading into a circle as you climb the building. To the east, there is a dark entrance, something shining gleaming from behind it.

You can see Owl here.

>s
You can't go that way.

>w
Town Square
A large clearing in the forest populated by dozens of wooden houses giving off a cozy feeling. There's solid ground underneath your feet, and a large ceiling above your head. You can't make out the material it's made out of. There's large streetlamps to illuminate the path and a large fountain of clear water in the middle. Children are dnacing in a circle in the bag, a cat is meowing from a roof. People walk around, chat, look at you as you stand at the entrance. An imposing clock tower can be seen from the distance, almost reaching the yellow round drawing of a moon. The smell of wood and bakeries is overwhelming.

You can see Old lady, Gentleman, Lotty, Nutcracker, Fisherman and Polly here.

>e
Clock Tower
An ancient clock tower, made with brown stone and covered in ivies that climbed its walls for ages. Its tower reaches well into the man-made ceiling, the tip of it nearly touching the yellow drawing of the inexistant moon of this world. The hands of time seem to flow seamlessly into the wrong side. As you enter the building, you're met with an owl guard whose head turns into your direction as your first footsteps echo through the marble-covered floor. To the north, you see a staircase that leads up the slim tower, seemingly leading into a circle as you climb the building. To the east, there is a dark entrance, something shining gleaming from behind it.

You can see Owl here.

>n
The owl lets you through.

Bell Tower
The climb up the stairs is arduous and dizzying. Something doesn't feel quite right as you ascend the endless tower. But then you exit, and a gust of harsh wind blows into your face. You find yourself at the top of the tower, right below the glowing painted moon. In front of you, there is a giant bell, filled with ancient reliefs and jewels, just ready to be rung. A fierce dragon stands in front of it protectively, asserting your intentions.

* * *

>ring bell
The dragon bows its head.
You rang the bell. It's soothing sound echoes through the area... Oh? But what's this? Something seems to have fallen out of it as you rung it.
You obtained the shiny key!

>ring bell
The dragon bows its head.
You rang the bell. It's soothing sound echoes through the area... Oh? But what's this? Something seems to have fallen out of it as you rung it.
You obtained the shiny key!

>w
You can't go that way.

>s
Clock Tower
An ancient clock tower, made with brown stone and covered in ivies that climbed its walls for ages. Its tower reaches well into the man-made ceiling, the tip of it nearly touching the yellow drawing of the inexistant moon of this world. The hands of time seem to flow seamlessly into the wrong side. As you enter the building, you're met with an owl guard whose head turns into your direction as your first footsteps echo through the marble-covered floor. To the north, you see a staircase that leads up the slim tower, seemingly leading into a circle as you climb the building. To the east, there is a dark entrance, something shining gleaming from behind it.

You can see Owl here.

>w
Town Square
A large clearing in the forest populated by dozens of wooden houses giving off a cozy feeling. There's solid ground underneath your feet, and a large ceiling above your head. You can't make out the material it's made out of. There's large streetlamps to illuminate the path and a large fountain of clear water in the middle. Children are dnacing in a circle in the bag, a cat is meowing from a roof. People walk around, chat, look at you as you stand at the entrance. An imposing clock tower can be seen from the distance, almost reaching the yellow round drawing of a moon. The smell of wood and bakeries is overwhelming.

You can see Old lady, Gentleman, Lotty, Nutcracker, Fisherman and Polly here.

>n
Dreams
You find yourself in another clearing of the forest, but the trees around you appear to be violet in color. There is a clear stream in the middle of the clearing through which busy colorful fish swim. Small dragonflowers swaying in the trees emit a gentle light.

You can see Weeping Blue and a horned rabbit here.

>e
Diverging path
As you move deeper into the forest, you can see a tree-lined path that splits left and right. There is a carving in the middle of a giant tree, barely noticeable.

* * *

>e
End of All
Your footsteps echo through the small wooden path as if the floor was made of marble instead of leaves. The world around you is starting to feel more and more like a dream, but your tired legs seem to suggest otherwise. There are knights in old black armor standing in front of a giant golden door. The imposing nature of the sight makes you realize this could be the end of the journey.

You can see a golden door, Left Knight and Right Knight here.

>unlock door with shiny key
You unlock the golden door.

>e
(first opening the golden door)

Fishtank
As you enter the last room, the thing that catches your eyes first is the giant goldfish with a red spot on its forehead, slowly floating in a waterless room as it directs its large eyes towards you. The fish - queen - stares at you for a long time, as if waiting for you to do something.

You can see a golden door and Goldfish here.

>i wish to leave
*** You wake up the next morning in your tiny old room, confused as to what has transpired. Your heart is pounding against your chest, and you slowly get out of your bed to turn on the lamp. Everything remains the same as the night you decided to go out to sea. You think back on the goldfish's words and head back to bed, knowing your worth. 
Thank you for playing! - E.K. ***

Would you like to RESTART, RESTORE a saved game, QUIT or UNDO the last command?

>undo
Fishtank
[Previous turn undone.]

>w
End of All
Your footsteps echo through the small wooden path as if the floor was made of marble instead of leaves. The world around you is starting to feel more and more like a dream, but your tired legs seem to suggest otherwise. There are knights in old black armor standing in front of a giant golden door. The imposing nature of the sight makes you realize this could be the end of the journey.

You can see a golden door, Left Knight and Right Knight here.

* * *

>e
Fishtank
As you enter the last room, the thing that catches your eyes first is the giant goldfish with a red spot on its forehead, slowly floating in a waterless room as it directs its large eyes towards you. The fish - queen - stares at you for a long time, as if waiting for you to do something.

You can see a golden door and Goldfish here.

>i wish to stay
*** The goldfish grants your wish of wanting to stay here forever. You now have a goldfish the size of an elephant to follow you around, friends and their families to support you, and more freedom in life than you had ever hoped to receive. 
Thank you for playing! - E.K. ***

Would you like to RESTART, RESTORE a saved game, QUIT or UNDO the last command?

* * *

>w
Dreams
You find yourself in another clearing of the forest, but the trees around you appear to be violet in color. There is a clear stream in the middle of the clearing through which busy colorful fish swim. Small dragonflowers swaying in the trees emit a gentle light.

You can see Weeping Blue and a horned rabbit here.

>show mirror to blue
Weeping Blue is unimpressed.

>inventor
That's not a verb I recognise.

>inventory
You are carrying:
  a mirror

>check gems
You currently have 0 gems.

* * *

>show mirror to weeping blue
Weeping Blue takes the cracked mirror from your hands and looks at herself. She suddenly smiles a brilliant smile.
Thank you very much, boy. I finally remember how I look like.
In the back, the horned rabbit's eyes shine.

>approach rabbit
The rabbit seems pleased with you that you've taken the time to help the woman out of her troubles. He wants you to follow him south, while shaking 50 gems out of its furr. You obtain the gems, and follow him wordlessly.

Town Square
A large clearing in the forest populated by dozens of wooden houses giving off a cozy feeling. There's solid ground underneath your feet, and a large ceiling above your head. You can't make out the material it's made out of. There's large streetlamps to illuminate the path and a large fountain of clear water in the middle. Children are dnacing in a circle in the bag, a cat is meowing from a roof. People walk around, chat, look at you as you stand at the entrance. An imposing clock tower can be seen from the distance, almost reaching the white round drawing of a moon. The smell of wood and bakeries is overwhelming.

You can see Old lady, Gentleman, Lotty, Nutcracker, Fisherman, Polly and a purse here.

>gem collection
That's not a verb I recognise.

>check gems
You currently have 50 gems.

>play rock for polly
SCISSORS!
Polly: I lost?!
Polly gives you a gem.

>play rock for polly
PAPER!
Polly: You lose! You lose!

>play rock for polly
PAPER!
Polly: You lose! You lose!

>play rock for polly
ROCK!
Polly: Draw!

>play rock for polly
SCISSORS!
Polly: I lost?!
Polly gives you a gem.

* * *

>play rock for polly
PAPER!
Polly: You lose! You lose!

>play rock for polly
SCISSORS!
Polly: I lost?!
Polly gives you a gem.

* * *

>play rock for polly
ROCK!
Polly: Draw!

>play rock for polly
ROCK!
Polly: Draw!

>play rock for polly
PAPER!
Polly: You lose! You lose!

* * *

>play rock for polly
SCISSORS!
Polly: I lost?!
Polly gives you a gem.

>play rock for polly
SCISSORS!
Polly: I lost?!

>play rock for polly
SCISSORS!
Polly: I lost?!

>play rock for polly
PAPER!
Polly: You lose! You lose!

I beg your pardon?

I beg your pardon?

>play rock for polly
ROCK!
Polly: Draw!

>play rock for polly
SCISSORS!
Polly: I lost?!

* * *

>play rock for polly
PAPER!
Polly: You lose! You lose!

>play scissors for polly
ROCK!
Polly: You lose! You lose!

>check gems
You currently have 55 gems.

>w
Tree-lined Path
A silent path. A few owls sit on the birch trees leading to the town square. The ceiling you've seen in the town square is nowhere to be seen, a thick white blanket covering the sky instead.

* * *

>w
Tavern
A lively place. A live band is performing is in the back, and dozens of people are gathered at tiny coffee tables, enjoying hot beverages.

You can see a black tea, chamomile tea, a slippery elm tea, Lars, Snowman, Dan, Ginny, Bugcatcher and Schoolteacher here.

>take black tea
Taken.

>take chamomile tea
Taken.

>take slippery elm tea
Taken.

>give black tea to dan
Dan: Not my order. But have you tried green tea? Green tea is very good for a whole lot of things. Hey - you're leaving already? Where are you - No response.

>give black tea to ginny
Ginny: Yes. That's my order, thank you.
No response.

>give slippery elm tea to dan
Dan: Ah, yes! My order! Thanks! I can continue talking in peace now.
No response.

>give chamomile tea to schoolteacher
Schoolteacher: Ah! Most wonderous!
The schoolteacher downs the tea.

>ask lars about the password
There is no reply.

>ask lars about password
Lars: The password is temporary hoot. Also - a bit of a compensation.
Obtained 30 gems!

>check gems
You currently have 85 gems.

>ask lars about him
Lars: There's nothing to me, kid. I sell tea and own this place. If you'd like to buy some, just ask me to make you one. It'll cost 10 gems. The world ain't for free.

>ask lars to make tea
I didn't understand that sentence.

>ask lars about making tea
Lars: Here you go.
Obtained hot tea.

>inventory
You are carrying:
  a hot tea
  a mirror

>e
Yard
A small yard leading to a cozy wooden tavern just west of here.

You can see Large Bear here.

* * *

>e
Tree-lined Path
A silent path. A few owls sit on the birch trees leading to the town square. The ceiling you've seen in the town square is nowhere to be seen, a thick white blanket covering the sky instead.

>r
That's not a verb I recognise.

>e
Town Square
A large clearing in the forest populated by dozens of wooden houses giving off a cozy feeling. There's solid ground underneath your feet, and a large ceiling above your head. You can't make out the material it's made out of. There's large streetlamps to illuminate the path and a large fountain of clear water in the middle. Children are dnacing in a circle in the bag, a cat is meowing from a roof. People walk around, chat, look at you as you stand at the entrance. An imposing clock tower can be seen from the distance, almost reaching the white round drawing of a moon. The smell of wood and bakeries is overwhelming.

You can see Old lady, Gentleman, Lotty, Nutcracker, Fisherman, Polly and a purse here.

>take purse
Before you could pick up the purse, the gentleman wearing that ridiculously large tophat you saw at the entrance stops you and bows to you.
Gentleman: What are you doing, young sir? You are in no way entitled to this woman's purse. Run along, now.
You decide to leave the purse where it is.

>give hot tea to gentleman
The gentleman wordlessly takes the cup of tea and goes to sit at the fountain to drink.

* * *

>inventory
You are carrying:
  a purse
  a hot tea
  a mirror

>look at purse
A fancy hot pink purse with a flower pin attached to it. Who could it belong to? What could it contain? The possibilities are endless.

>look through purse
You find nothing of interest.

>reach into purse
You reach into the purse. There's 50 gems in it. You take them with you.

>gem collection
That's not a verb I recognise.

>check gems
You currently have 125 gems.

>e
Clock Tower
An ancient clock tower, made with brown stone and covered in ivies that climbed its walls for ages. Its tower reaches well into the man-made ceiling, the tip of it nearly touching the yellow drawing of the inexistant moon of this world. The hands of time seem to flow seamlessly into the wrong side. As you enter the building, you're met with an owl guard whose head turns into your diretion as your first footsteps echo through the marble-covered floor. To the west, you see a staircase that leads up the slim tower, seemingly leading into a circle as you climb the building. To the east, there is a dark entrance, something shining gleaming from behind it.

You can see Owl here.

>temporal hoot
The owl's eyes widen and it hoots. The clock behind it shows time ticking in the right direction again.

>e
Treasury
A large open room filled with the brim with gold coins and gems. A large dragon sleeps on top of it all, snoring contently. There's a worn sign here.

* * *

>deposit gems
You deposited 100 gems for dragon profit.

>w
Clock Tower
An ancient clock tower, made with brown stone and covered in ivies that climbed its walls for ages. Its tower reaches well into the man-made ceiling, the tip of it nearly touching the yellow drawing of the inexistant moon of this world. The hands of time seem to flow seamlessly into the wrong side. As you enter the building, you're met with an owl guard whose head turns into your diretion as your first footsteps echo through the marble-covered floor. To the west, you see a staircase that leads up the slim tower, seemingly leading into a circle as you climb the building. To the east, there is a dark entrance, something shining gleaming from behind it.

You can see Owl here.

>w
Bell Tower
The climb up the stairs is arduous and dizzying. Something doesn't feel quite right as you ascend the endless tower. But then you exit, and a gust of harsh wind blows into your face. You find yourself at the top of the tower, right below the glowing painted moon. In front of you, there is a giant bell, filled with ancient reliefs and jewels, just ready to be rung. A fierce dragon stands in front of it protectively, asserting your intentions.

>ring bel
I didn't understand that sentence.

>ring bell
You rang the bell. It's soothing sound echoes through the area... Oh? But what's this? Something seems to have fallen out of it as you rung it.
You obtained the shiny key!

>inventory
You are carrying:
  a shiny key
  a purse
  a hot tea
  a mirror

>e
Clock Tower
An ancient clock tower, made with brown stone and covered in ivies that climbed its walls for ages. Its tower reaches well into the man-made ceiling, the tip of it nearly touching the yellow drawing of the inexistant moon of this world. The hands of time seem to flow seamlessly into the wrong side. As you enter the building, you're met with an owl guard whose head turns into your diretion as your first footsteps echo through the marble-covered floor. To the west, you see a staircase that leads up the slim tower, seemingly leading into a circle as you climb the building. To the east, there is a dark entrance, something shining gleaming from behind it.

You can see Owl here.

>s
You can't go that way.

>w
Bell Tower
The climb up the stairs is arduous and dizzying. Something doesn't feel quite right as you ascend the endless tower. But then you exit, and a gust of harsh wind blows into your face. You find yourself at the top of the tower, right below the glowing painted moon. In front of you, there is a giant bell, filled with ancient reliefs and jewels, just ready to be rung. A fierce dragon stands in front of it protectively, asserting your intentions.

>e
Clock Tower
An ancient clock tower, made with brown stone and covered in ivies that climbed its walls for ages. Its tower reaches well into the man-made ceiling, the tip of it nearly touching the yellow drawing of the inexistant moon of this world. The hands of time seem to flow seamlessly into the wrong side. As you enter the building, you're met with an owl guard whose head turns into your diretion as your first footsteps echo through the marble-covered floor. To the west, you see a staircase that leads up the slim tower, seemingly leading into a circle as you climb the building. To the east, there is a dark entrance, something shining gleaming from behind it.

You can see Owl here.

>e
Treasury
A large open room filled with the brim with gold coins and gems. A large dragon sleeps on top of it all, snoring contently. There's a worn sign here.

>w
Clock Tower
An ancient clock tower, made with brown stone and covered in ivies that climbed its walls for ages. Its tower reaches well into the man-made ceiling, the tip of it nearly touching the yellow drawing of the inexistant moon of this world. The hands of time seem to flow seamlessly into the wrong side. As you enter the building, you're met with an owl guard whose head turns into your diretion as your first footsteps echo through the marble-covered floor. To the west, you see a staircase that leads up the slim tower, seemingly leading into a circle as you climb the building. To the east, there is a dark entrance, something shining gleaming from behind it.

You can see Owl here.

>n
You can't go that way.

>s
You can't go that way.

>e
Treasury
A large open room filled with the brim with gold coins and gems. A large dragon sleeps on top of it all, snoring contently. There's a worn sign here.

>e
You can't go that way.

>w
Clock Tower
An ancient clock tower, made with brown stone and covered in ivies that climbed its walls for ages. Its tower reaches well into the man-made ceiling, the tip of it nearly touching the yellow drawing of the inexistant moon of this world. The hands of time seem to flow seamlessly into the wrong side. As you enter the building, you're met with an owl guard whose head turns into your diretion as your first footsteps echo through the marble-covered floor. To the west, you see a staircase that leads up the slim tower, seemingly leading into a circle as you climb the building. To the east, there is a dark entrance, something shining gleaming from behind it.

You can see Owl here.

* * *

>w
Bell Tower
The climb up the stairs is arduous and dizzying. Something doesn't feel quite right as you ascend the endless tower. But then you exit, and a gust of harsh wind blows into your face. You find yourself at the top of the tower, right below the glowing painted moon. In front of you, there is a giant bell, filled with ancient reliefs and jewels, just ready to be rung. A fierce dragon stands in front of it protectively, asserting your intentions.

>w
You can't go that way.

>e
Clock Tower
An ancient clock tower, made with brown stone and covered in ivies that climbed its walls for ages. Its tower reaches well into the man-made ceiling, the tip of it nearly touching the yellow drawing of the inexistant moon of this world. The hands of time seem to flow seamlessly into the wrong side. As you enter the building, you're met with an owl guard whose head turns into your diretion as your first footsteps echo through the marble-covered floor. To the west, you see a staircase that leads up the slim tower, seemingly leading into a circle as you climb the building. To the east, there is a dark entrance, something shining gleaming from behind it.

You can see Owl here.

* * *

>inventory
You are carrying:
  a mirror

>show mirror
Whom do you want to show the mirror to?

>weeping blue
the mirror takes the cracked mirror from your hands and looks at herself. She suddenly smiles a brilliant smile.
Thank you very much, boy. I finally remember. now I hope my necklace helps you in some way.
In the back, the horned rabbit's eyes shine.

>check gems
You currently have 0 gems.

>show mirror
Whom do you want to show the mirror to?

* * *

>inventory
You are carrying:
  a mirror

>show mirror to weeping blue
Weeping Blue takes the cracked mirror from your hands and looks at herself. She suddenly smiles a brilliant smile.
Thank you very much, boy. I finally remember. now I hope my necklace helps you in some way.
In the back, the horned rabbit's eyes shine.

>look at horned rabbit
A white horned rabbit, curiously looking your way. No matter what you do, it seems intent on following. Try approaching it!

>approach horned rabbit
The rabbit seems pleased with you that you've taken the time to help the woman out of her troubles. He wants you to follow him, while shaking 50 gems out of its furr.

Town Square

>check gems
You currently have 50 gems.

* * *

>take mirror
Upon taking the cracked mirror, the other items magically disappear... You decide to go back.

Clearing
It's dark and foggy, so you don't see much. There's dark grass bluish in color from the light emitted by the few fireflies swirling around you. Trees as far and wide as the eye can see. There's an old sign here.

>w
Hidden Cave
A small dark cave. You hear drops of water slowly fall to the watery ground beneath you. It's surprisingly cold for such a small space.

You can see a duck and a breadloaf here.

>e
Clearing
It's dark, so you don't see much. There's dark grass bluish in color from the light emitted by the few fireflies swirling around you. Trees as far and wide as the eye can see.

You can see an old sign here.

>s
First path
As you move deeper into the forest, you can see a tree-lined path that splits left and right. There is a carving in the middle of a giant tree, barely noticeable.

* * *

>w
Dreams
You find yourself in another clearing of the forest, but the trees around you appear to be violet in color. There is a clear stream in the middle of the clearing through which busy colorful fish swim. Small dragonflowers swaying in the trees emit a gentle light.

You can see Weeping Blue and a horned rabbit here.

>ask weeping blue about what happened
Weeping Blue:  I've been here for so long, I have forgotten how my face looks. And the stream is filled with fish, and I don't look like a fish, I know that much!

>ask weeping blue about looking like a fish
Weeping Blue: Do not laugh at my misery! I am no fish!

>look at fishes
Very buys-looking red fishes. They swim through the stream rather quickly, and you can't make out anything else other than fish. You would jump into water to scare them off, were you not deathly afraid of the fish swimming in the stream in the first place.

>ask weeping blue about where i am
Weeping Blue: You seem new here. I was just like you when I first arrived. Listen - this place is nothing like what they've promised you. If you have the chance to leave - go - retreat. Don't ake the same mistake I did.

>ask weeping blue about town square
Weeping Blue: Town Square? I have no business with the town square. I know some people around here care much more. I only care about my face.

>show mirror to weeping blue
Weeping Blue is unimpressed.

* * *

>take mirror
Upon taking the cracked mirror, the other items magically disappear... You decide to go back.

Clearing
It's dark and foggy, so you don't see much. There's dark grass bluish in color from the light emitted by the few fireflies swirling around you. Trees as far and wide as the eye can see. There's an old sign here.

>n
You have all the items you could get. Time to move on.

>n
You have all the items you could get. Time to move on.

* * *

>n
Treestump
A large treestump is lying vertically on the ground of the clearing. A few toadstools sit around it, acting as lamps.

You can see a flashlight, a mirror and a fishhook here.

>take fishhook
Upon taking the hook, the other items magically disappear... You decide to go back.

Clearing
It's dark and foggy, so you don't see much. There's dark grass bluish in color from the light emitted by the few fireflies swirling around you. Trees as far and wide as the eye can see. There's an old sign here.

>s
Diverging path
As you move deeper into the forest, you can see a tree-lined path that splits left and right. There is a carving in the middle of a giant tree, barely noticeable.

* * *

>w
Dreams
You find yourself in another clearing of the forest, but the trees around you appear to be violet in color. There is a clear stream in the middle of the clearing through which busy colorful fish swim. Small dragonflowers swaying in the trees emit a gentle light.

You can see Weeping Blue and a horned rabbit here.

>catch rabbit
You run after the horned rabbit and it starts fleeing. You follow the rabbit out of the clearing, landing in a new area.

Town Square
A large clearing in the forest populated by dozens of wooden houses giving off a cozy feeling. There's solid ground underneath your feet, and a large ceiling above your head. You can't make out the material it's made out of. There's large streetlamps to illuminate the path and a large fountain of clear water in the middle. Children are dnacing in a circle in the bag, a cat is meowing from a roof. People walk around, chat, look at you as you stand at the entrance. An imposing clock tower can be seen from the distance, almost reaching the white round drawing of a moon. The smell of wood and bakeries is overwhelming.

You can see Old lady, Gentleman, Lotty, Nutcracker, Fisherman, Polly and a purse here.

>help fisherman tie hook
You tie the fisherman's hook to the pole with a smile. The fisherman gives you 20 gems as compensation, which you politely decline. But the fisherman stuffs them into your hand nevertheless.

* * *

>w
Tree-lined Path
A silent path. A few owls sit on the birch trees leading to the town square. The ceiling you've seen in the town square is nowhere to be seen, a thick white blanket covering the sky instead.

>e
Town Square
A large clearing in the forest populated by dozens of wooden houses giving off a cozy feeling. There's solid ground underneath your feet, and a large ceiling above your head. You can't make out the material it's made out of. There's large streetlamps to illuminate the path and a large fountain of clear water in the middle. Children are dnacing in a circle in the bag, a cat is meowing from a roof. People walk around, chat, look at you as you stand at the entrance. An imposing clock tower can be seen from the distance, almost reaching the white round drawing of a moon. The smell of wood and bakeries is overwhelming.

You can see Old lady, Gentleman, Lotty, Nutcracker, Fisherman, Polly and a purse here.

>n
Dreams
You find yourself in another clearing of the forest, but the trees around you appear to be violet in color. There is a clear stream in the middle of the clearing through which busy colorful fish swim. Small dragonflowers swaying in the trees emit a gentle light.

You can see Weeping Blue and a horned rabbit here.

>reach for gold
You reach for the golden object shimmering in the stream, but your head suddenly starts to hurt horribly, stopping you in your action.
You want to remember... You feel a surge of energy! Defense increased by 2!

>s
Town Square
A large clearing in the forest populated by dozens of wooden houses giving off a cozy feeling. There's solid ground underneath your feet, and a large ceiling above your head. You can't make out the material it's made out of. There's large streetlamps to illuminate the path and a large fountain of clear water in the middle. Children are dnacing in a circle in the bag, a cat is meowing from a roof. People walk around, chat, look at you as you stand at the entrance. An imposing clock tower can be seen from the distance, almost reaching the white round drawing of a moon. The smell of wood and bakeries is overwhelming.

You can see Old lady, Gentleman, Lotty, Nutcracker, Fisherman, Polly and a purse here.

* * *

>tell joke to old lady
You tell the old lady a knock knock joke, and she bawls from laughter. As reward, you're given a cookie from her basket.

>ask lotty about dragon
Lotty: The dragon sleeps at the bottom of the clock tower and needs only a swing of its wings to climb the tower.
Lotty: But in the off chance that it attacks you... Maybe this will help!
Lotty produces an omelette out of her basket and shoves it into your hands clumsily.

>look at lotty
A young girl half your size but around your age, dressed in old garbs and neatly-done braids. She's looking rather distressed.

>w
Tree-lined Path
A silent path. A few owls sit on the birch trees leading to the town square. The ceiling you've seen in the town square is nowhere to be seen, a thick white blanket covering the sky instead.

* * *

>take chamomile tea
Taken.

>give chamomile tea to genny
You can't see any such thing.

>give chamomile tea to ginny
Ginny: No, thank you. I still have so much to learn and... I must prove myself.
Ginny's words echo through you. Something about them feels so familiar... You want to remember. You feel a surge of power! Defense rose by 3!

>remember
You're still getting dizzy as you try to remember. There was a storm. And something golden in it. You're sure of it.

>e
Yard
A small yard leading to a cozy wooden tavern just west of here.

You can see Large Bear here.

* * *

>e
Calm Pond
A small pond, perfectly still. The sky is covered in white, unmoving clouds. There is a wooden platform next to the north of here. You see a young man sitting on said platform in the distance.

You can see a bucket here.

>take bucket
Taken.

>n
Wooden Platform
A simple wooden platform for fishermen to sit at and put their belongings on.

You can see Murmur here.

>give bucket to murmur
The young man extends his hand to take the item. He nods curtly, then fastens one of the worms to the hook. You'll never like the sight of it.

>ask murmur about how his father got here
There is no reply.

>ask murmur about how his father came here
Murmur: He went... fishing one day. Then disappeared. It was just me and my father, back then. When he didn't come back, I...
He winces.
Murmur: I found his straw hat the same day, near the lake where he would fish every day. But there was no sign of him. For a year. He always wished for a change... I gave up evetually. Just continued fishing by the lake.
Your head starts to hurt. You want to remember... You feel a surge of power! Increased attack by 2.

>s
Calm Pond
A small pond, perfectly still. The sky is covered in white, unmoving clouds. There is a wooden platform next to the north of here. You see a young man sitting on said platform in the distance.

>r
That's not a verb I recognise.

>e
Tree-lined Path
A silent path. A few owls sit on the birch trees leading to the town square. The ceiling you've seen in the town square is nowhere to be seen, a thick white blanket covering the sky instead.

* * *

I beg your pardon?

>inventory
You are carrying:
  chamomile tea
  an omelette
  a cookie
  a fishhook

>w
Tree-lined Path
A silent path. A few owls sit on the birch trees leading to the town square. The ceiling you've seen in the town square is nowhere to be seen, a thick white blanket covering the sky instead.

>w
Calm Pond
A small pond, perfectly still. The sky is covered in white, unmoving clouds. There is a wooden platform next to the north of here. You see a young man sitting on said platform in the distance.

I beg your pardon?

* * *

>w
Yard
A small yard leading to a cozy wooden tavern just west of here.

You can see Large Bear here.

>w
Tavern
A lively place. A live band is performing is in the back, and dozens of people are gathered at tiny coffee tables, enjoying hot beverages.

You can see a black tea, a slippery elm tea, Lars, Snowman, Dan, Ginny, Bugcatcher and Schoolteacher here.

>ask lars about making tea
Lars: Here you go.
Obtained hot tea.

* * *

>e
Yard
A small yard leading to a cozy wooden tavern just west of here.

You can see Large Bear here.

>e
Calm Pond
A small pond, perfectly still. The sky is covered in white, unmoving clouds. There is a wooden platform next to the north of here. You see a young man sitting on said platform in the distance.

>e
Tree-lined Path
A silent path. A few owls sit on the birch trees leading to the town square. The ceiling you've seen in the town square is nowhere to be seen, a thick white blanket covering the sky instead.

* * *

>take purse
You take the purse.

>w
Tree-lined Path
A silent path. A few owls sit on the birch trees leading to the town square. The ceiling you've seen in the town square is nowhere to be seen, a thick white blanket covering the sky instead.

* * *

>w
Calm Pond
A small pond, perfectly still. The sky is covered in white, unmoving clouds. There is a wooden platform next to the north of here. You see a young man sitting on said platform in the distance.

>w
Yard
A small yard leading to a cozy wooden tavern just west of here.

You can see Large Bear here.

>give purse to large bear
The bear seems ecstatic! It lurches forward, grabs the purse from your hands and swings it over its shoulder. She bats her eyelashes at you. She politely reaches into her purse to - somehow - pull out a diamond sword.
Equipping the diamond sword, your attack rose!

>r
That's not a verb I recognise.

>e
Calm Pond
A small pond, perfectly still. The sky is covered in white, unmoving clouds. There is a wooden platform next to the north of here. You see a young man sitting on said platform in the distance.

* * *

>e
Tree-lined Path
A silent path. A few owls sit on the birch trees leading to the town square. The ceiling you've seen in the town square is nowhere to be seen, a thick white blanket covering the sky instead.

>e
Town Square
A large clearing in the forest populated by dozens of wooden houses giving off a cozy feeling. There's solid ground underneath your feet, and a large ceiling above your head. You can't make out the material it's made out of. There's large streetlamps to illuminate the path and a large fountain of clear water in the middle. Children are dnacing in a circle in the bag, a cat is meowing from a roof. People walk around, chat, look at you as you stand at the entrance. An imposing clock tower can be seen from the distance, almost reaching the white round drawing of a moon. The smell of wood and bakeries is overwhelming.

You can see Old lady, Gentleman, Lotty, Nutcracker, Fisherman and Polly here.

>e
Clock Tower
An ancient clock tower, made with brown stone and covered in ivies that climbed its walls for ages. Its tower reaches well into the man-made ceiling, the tip of it nearly touching the yellow drawing of the inexistant moon of this world. The hands of time seem to flow seamlessly into the wrong side. As you enter the building, you're met with an owl guard whose head turns into your diretion as your first footsteps echo through the marble-covered floor. To the north, you see a staircase that leads up the slim tower, seemingly leading into a circle as you climb the building. To the east, there is a dark entrance, something shining gleaming from behind it.

You can see Owl here.

>temporal hoot
The owl's eyes widen and it hoots.

>w
Town Square
A large clearing in the forest populated by dozens of wooden houses giving off a cozy feeling. There's solid ground underneath your feet, and a large ceiling above your head. You can't make out the material it's made out of. There's large streetlamps to illuminate the path and a large fountain of clear water in the middle. Children are dnacing in a circle in the bag, a cat is meowing from a roof. People walk around, chat, look at you as you stand at the entrance. An imposing clock tower can be seen from the distance, almost reaching the white round drawing of a moon. The smell of wood and bakeries is overwhelming.

You can see Old lady, Gentleman, Lotty, Nutcracker, Fisherman and Polly here.

* * *

>n
The owl lets you through.

Bell Tower
The climb up the stairs is arduous and dizzying. Something doesn't feel quite right as you ascend the endless tower. But then you exit, and a gust of harsh wind blows into your face. You find yourself at the top of the tower, right below the glowing painted moon. In front of you, there is a giant bell, filled with ancient reliefs and jewels, just ready to be rung. A fierce dragon stands in front of it protectively, asserting your intentions.

* * *

>ass
That's not a verb I recognise.

>aass
That's not a verb I recognise.

>ring bell
The dragon suddely attacked! You have to defeat it before you can ring the bell! You can either attack, defend from dragon, or use consumables!

>attack dragon
You swing at the dragon with all your might! The dragon takes 17 damage!

DRAGON'S TURN
The dragon blows fire! You lost 10 HP!

>attack dragon
You swing at the dragon with all your might! The dragon takes 17 damage!

DRAGON'S TURN
The dragon has to recharge and does nothing this turn.

>attack dragon
You swing at the dragon with all your might! The dragon takes 17 damage!

DRAGON'S TURN
The dragon swings its claws at you! You lost 5 HP!

>check hp
You currently have 15 HP.

>attack dragon
You swing at the dragon with all your might! The dragon takes 17 damage!

DRAGON'S TURN
The dragon swings its claws at you! You lost 5 HP!

>eat omelette
You ate the omelette. HP up!

DRAGON'S TURN
The dragon has to recharge and does nothing this turn.

>attack dragon
You swing at the dragon with all your might! The dragon takes 17 damage!

DRAGON'S TURN
The dragon blows fire! You lost 10 HP!

>eat omelette
You can't see any such thing.

>attack dragon
You swing at the dragon with all your might! The dragon takes 17 damage!
The dragon is defeated! It bows to you and clears the way to the bell.

* * *

>ring bell
The dragon bows its head.
You rang the bell. It's soothing sound echoes through the area... Oh? But what's this? Something seems to have fallen out of it as you rung it.
You obtained the shiny key!

>s
Clock Tower
An ancient clock tower, made with brown stone and covered in ivies that climbed its walls for ages. Its tower reaches well into the man-made ceiling, the tip of it nearly touching the yellow drawing of the inexistant moon of this world. The hands of time seem to flow seamlessly into the wrong side. As you enter the building, you're met with an owl guard whose head turns into your diretion as your first footsteps echo through the marble-covered floor. To the north, you see a staircase that leads up the slim tower, seemingly leading into a circle as you climb the building. To the east, there is a dark entrance, something shining gleaming from behind it.

You can see Owl here.

* * *

>e
(first opening the golden door)
It seems to be locked.

>unlock golden door
What do you want to unlock the golden door with?

>shiny key
You unlock the golden door.

>e
(first opening the golden door)

Fishtank
As you enter the last room, the thing that catches your eyes first is the giant goldfish with a red spot on its forehead, slowly floating in a waterless room as it directs its large eyes towards you. The fish - queen - stares at you for a long time, as if waiting for you to do something.

You can see a golden door and Goldfish here.

>ask goldfish about why she saved me
Goldfish: I cannot answer you that.

>show fishhook to goldfish
Goldfish: So. You remember.
 The Goldfish floats towards the ground carefully, its giant frilly fins floating about as if it's underwater. It comes close to you until you're the perfect distance to lay your hand upon its head. 
A dark choppy sea slams into your boat, rocking you left and right ithrough the endless blue. You hold tight to your fishing rod, unwilling to let go of the creature that's hanging onto the other side of your hook. You reel the creature in, but it fights back, obviously much stronger than you are.
You've never been especially strong, scrawny and scared of just about anything. The storm that's trying to drag you into the mire came so suddenly, with no winds predicting a change. You have no home to return to, no one to care but yourself. And you wanted to see for yourself just how much you can do - wanted a chance to prove yourself. If you were to catch the beast that dwells in the depths...
But as you finally reel the fish in, with thunderous clouds chasing in on you, all that comes from it is a single, cute goldfish with a red spot on its forehead. You fall to your knees with the fish in your hands. You slowly lower it back into the water.
The thunder is getting louder. The water is filling up your boat. You wish to survive. You wish for another chance. You wish to -  You wish to live. 
You find yourself back in front of the giant goldfish, who slowly parts from you. She looks you in the eye. This creature brought you here - to save your life.

>ask goldfish about wish
Goldfish:  You've proven you're strong and capable to come this far. I grant you one other wish - and that is to stay, or to leave. 
If you leave, you will not be able to continue living in this world, and everyone you've met here will forget of your existence. Such are the rules of this world. You will, however, return home, to your world, stronger and wiser, and will be able to rethink your journey to the sea. 
If you wish to stay, however, you will never again be able to return to the real world, but you will be able to stay here, with everyone you've met, all of your memories intact and safe. You might even choose to live life differently, here.
When you are ready, come here, and simply say "I wish to leave", or "I wish to stay". Nevertheless, your adventure will come to an end.

>i wish to stay
*** The goldfish grants your wish of wanting to stay here forever. You now have a goldfish the size of an elephant to follow you around, friends and their families to support you, and more freedom in life than you had ever hoped to receive. 
Thank you for playing! - E.K. ***

Would you like to RESTART, RESTORE a saved game, QUIT or UNDO the last command?

>undo
Fishtank
[Previous turn undone.]

>i wish to leave
*** You wake up the next morning in your tiny old room, confused as to what has transpired. Your heart is pounding against your chest, and you slowly get out of your bed to turn on the lamp. Everything remains the same as the night you decided to go out to sea. You think back on the goldfish's words and head back to bed, knowing your worth. 
Thank you for playing! - E.K. ***

Would you like to RESTART, RESTORE a saved game, QUIT or UNDO the last command?

* * *

>w
Dreams
You find yourself in another clearing of the forest, but the trees around you appear to be violet in color. There is a clear stream in the middle of the clearing through which busy colorful fish swim. Small dragonflowers swaying in the trees emit a gentle light.

You can see Weeping Blue and a horned rabbit here.

>s
Town Square
A large clearing in the forest populated by dozens of wooden houses giving off a cozy feeling. There's solid ground underneath your feet, and a large ceiling above your head. You can't make out the material it's made out of. There's large streetlamps to illuminate the path and a large fountain of clear water in the middle. Children are dnacing in a circle in the bag, a cat is meowing from a roof. People walk around, chat, look at you as you stand at the entrance. An imposing clock tower can be seen from the distance, almost reaching the white round drawing of a moon. The smell of wood and bakeries is overwhelming.

You can see Old lady, Gentleman, Lotty, Nutcracker, Fisherman and Polly here.

* * *

>w
Calm Pond
A small pond, perfectly still. The sky is covered in white, unmoving clouds. There is a wooden platform next to the north of here. You see a young man sitting on said platform in the distance.

>n
Wooden Platform
A simple wooden platform for fishermen to sit at and put their belongings on.

You can see Murmur here.

>ask murmur about how he came here
There is no reply.

>ask murmur about how he got here
There is no reply.

>ask murmur about how he came to this world
Murmur: You remember your own wish, don't you... Fine. My father wanted a change, and wished himself away. Mine was to find him again. I've found much that I hold dear here, so I don't regret it. Wishes have a way of coming true in the most unconventional way, don't they?

* * *

>check gems
You currently have 0 gems.

>n
Treestump
A large treestump is lying vertically on the ground of the clearing. A few toadstools sit around it, acting as lamps.

You can see a flashlight, a mirror and a fishhook here.

* * *

>take mirror
Upon taking the cracked mirror, the other items magically disappear... You decide to go back.

Clearing
It's dark, so you don't see much. There's dark grass bluish in color from the light emitted by the few fireflies swirling around you. Trees as far and wide as the eye can see.

You can see an old sign here.

>check sign
On the sign, you can make out faded words made with black oil paint. It says "Go north. Choose one. Go south. Choose any."

>s
First path
As you move deeper into the forest, you can see a tree-lined path that splits left and right. There is a carving in the middle of a giant tree, barely noticeable.

* * *

>n
Treestump
A large treestump is lying vertically on the ground of the clearing. A few toadstools sit around it, acting as lamps.

You can see a flashlight, a mirror and a fishhook here.

>take flashlight
Upon taking the flashlight, the other items magically disappear... You decide to go back.

Clearing
It's dark, so you don't see much. There's dark grass bluish in color from the light emitted by the few fireflies swirling around you. Trees as far and wide as the eye can see.

You can see an old sign here.

>check gems
You currently have 50 gems.

* * *

>check gems
You currently have 0 gems.

>s
First path
As you move deeper into the forest, you can see a tree-lined path that splits left and right. There is a carving in the middle of a giant tree, barely noticeable.

* * *

>s
Town Square
You can see Old lady, Gentleman, Curious girl, Nutcracker, Fisherman, Polly and a purse here.

>play rock for polly
ROCKDraw!

>check gems
You currently have 0 gems.

>play rock for polly
PAPERYou lose! You lose!

>check gems
You currently have 0 gems.

>play rock for polly
ROCKDraw!

>play rock for polly
SCISSORSI lost?!
Polly gives you a gem.

>play rock for polly
SCISSORSI lost?!
Polly gives you a gem.

>play rock for polly
ROCKDraw!

>play rock for polly
ROCKDraw!

* * *

>play rock for polly
SCISSORSI lost?!
Polly gives you a gem.

>play rock for polly
PAPERYou lose! You lose!

>play rock for polly
PAPERYou lose! You lose!

>play rock for polly
SCISSORSI lost?!
Polly gives you a gem.

* * *

>play rock for polly
PAPERYou lose! You lose!

>play rock for polly
ROCKDraw!

>play rock for polly
PAPERYou lose! You lose!

>play rock for polly
SCISSORSI lost?!

>play rock for polly
ROCKDraw!

>play rock for polly
SCISSORSI lost?!

>check gems
You currently have 5 gems.

>play rock for polly
PAPERYou lose! You lose!

* * *

>check gems
You currently have 0 gems.

>e
Hidden Cave
A small dark cave. You hear drops of water slowly fall to the watery ground beneath you. It's surprisingly cold for such a small space.

You can see a duck here.

>w
Clearing
It's dark and foggy, so you don't see much. There's dark grass bluish in color from the light emitted by the few fireflies swirling around you. Trees as far and wide as the eye can see.

You can see an old sign here.

>s
Diverging path
As you move deeper into the forest, you can see a tree-lined path that splits left and right. There is a carving in the middle of a giant tree, barely noticeable.

>e
End of All
Your footsteps echo through the small wooden path as if the floor was made of marble instead of leaves. The world around you is starting to feel more and more like a dream, but your tired legs seem to suggest otherwise. There are knights in old black armor standing in front of a giant golden door. The imposing nature of the sight makes you realize this could be the end of the journey.

You can see a golden door, Left knight and Right knight here.

>ask left knight about help
The knight scoffs at you rudely.

>ask right knight about help
The knight shakes his head politely.

>push golden door
You push against the door with all might, but nothing happens.

>demand from left knight to open the door
The knight refuses to move and ignores you.

>demand from right knight to open the door
The knight refuses to move and ignores you. But this knight is nice, so you feel bad for shouting at him. You gently leave behind 50 G.

>check gems
You currently have 0 gems.

* * *

>w
You can't go that way.

>look at duck
A sitting white duck. It's sitting on a rock in the middle of the room, its thick feathers covering its feet. It's kind of cute. Did it get lost?

>take duck
Taken.

>look at duck
A sitting white duck. It's feathers are very soft

* * *

>take duck
Taken.

>inverntory
That's not a verb I recognise.

>inventory
You are carrying:
  a duck

>look at duck
A sitting white duck. It's feathers are very soft to the touch - agh! It bit you!

* * *

>look at duck
A sitting white duck. It's sitting on a rock in the middle of the room, its thick feathers covering its feet. It's kind of cute. Did it get lost?

>look at breadloaf
You see nothing special about the breadloaf.

>take duck
The duck won't move from its spot. It hisses at you.

>inventory
You are carrying nothing.

>take breadloaf
Taken.

>inventory
You are carrying:
  a breadloaf

>take duck
The duck eyes the bread hungrily. You prepare to feed the bird, but it lunges at you and steals the bread. You got the duck, but lost the breadloaf in the process.

>take duck
You are already carrying the creature.

>inventory
You are carrying:
  a duck

>e
Clearing
It's dark, so you don't see much. There's dark grass bluish in color from the light emitted by the few fireflies swirling around you. Trees as far and wide as the eye can see.

You can see an old sign here.

>inventory
You are carrying:
  a duck

>w
Hidden Cave
A small dark cave. You hear drops of water slowly fall to the watery ground beneath you. It's surprisingly cold for such a small space.

>look around
You can't see any such thing.

* * *

>w
You can't go that way.

>take duck
The duck won't move from its spot. It hisses at you.

>look at duck
A sitting white duck. It's sitting on a rock in the middle of the room, its thick feathers covering its feet. It's kind of cute. Did it get lost?

>inventory
You are carrying nothing.

>take duck
The duck won't move from its spot. It hisses at you.

>take breadloaf
Taken.

* * *

>inventory
You are carrying:
  a duck
  a breadloaf

>look at duck
A sitting white duck. It's feathers are very soft to the touch - agh! It bit you!

* * *

>inventory
You are carrying:
  a breadloaf

>e
Clearing
It's dark, so you don't see much. There's dark grass bluish in color from the light emitted by the few fireflies swirling around you. Trees as far and wide as the eye can see.

You can see an old sign here.

>inventory
You are carrying:
  a breadloaf

>w
Hidden Cave
A small dark cave. You hear drops of water slowly fall to the watery ground beneath you. It's surprisingly cold for such a small space.

You can see a duck here.

>take duck
The duck eyes the bread hungrily. You prepare to feed the bird, but it lunges at you and steals the bread. You got the duck, but lost the breadloaf in the process.

>w
You can't go that way.

* * *

>take duck
The duck won't move from its spot. It hisses at you.

>inventory
You are carrying:
  a duck

* * *

>w
You can't go that way.

>catch duck
You want to take the duck by force, so the duck uses its force back.
You lost 5 HP!

>check hp
You currently have 20 HP.

>catch duck
You want to take the duck by force, so the duck uses its force back. You lost 10 HP.

>check hp
You currently have 10 HP.

>take duck
The duck won't move from its spot. It hisses at you.

>e
Clearing
It's dark and foggy, so you don't see much. There's dark grass bluish in color from the light emitted by the few fireflies swirling around you. Trees as far and wide as the eye can see.

You can see an old sign here.

>s
First path
As you move deeper into the forest, you can see a tree-lined path that splits left and right. There is a carving in the middle of a giant tree, barely noticeable.

* * *

>w
Dreams
You find yourself in another clearing of the forest, but the trees around you appear to be violet in color. There is a clear stream in the middle of the clearing through which busy colorful fish swim. Small dragonflowers swaying in the trees emit a gentle light.

You can see Weeping Blue and a horned rabbit here.

>s
Town Square
You can see Old lady, Gentleman, Lotty, Nutcracker, Fisherman, Polly and a purse here.

>tell joke to old lady
You tell the old lady a knock knock joke, and she bawls from laughter. As reward, you're given a cookie from her basket.

>e
You can't go that way.

>w
Calm Pond
A small pond, perfectly still. The sky is covered in white, unmoving clouds. There is a wooden platform next to the north of here. You see a young man sitting on said platform in the distance.

You can see a bucket here.

>e
Town Square
You can see Old lady, Gentleman, Lotty, Nutcracker, Fisherman, Polly and a purse here.

>n
Dreams
You find yourself in another clearing of the forest, but the trees around you appear to be violet in color. There is a clear stream in the middle of the clearing through which busy colorful fish swim. Small dragonflowers swaying in the trees emit a gentle light.

You can see Weeping Blue and a horned rabbit here.

* * *

>w
You can't go that way.

>r
That's not a verb I recognise.

>e
First path
As you move deeper into the forest, you can see a tree-lined path that splits left and right. There is a carving in the middle of a giant tree, barely noticeable.

>n
Clearing
It's dark and foggy, so you don't see much. There's dark grass bluish in color from the light emitted by the few fireflies swirling around you. Trees as far and wide as the eye can see.

You can see an old sign here.

>w
Hidden Cave
A small dark cave. You hear drops of water slowly fall to the watery ground beneath you. It's surprisingly cold for such a small space.

You can see a duck here.

>take duck
The duck eyes the cookie you're carrying hungrily. You prepare to feed the bird, but it lunges at you and steals the cookie. You got the duck, but lost the cookie in the process.

>inventory
You are carrying:
  a duck

>e
Clearing
It's dark and foggy, so you don't see much. There's dark grass bluish in color from the light emitted by the few fireflies swirling around you. Trees as far and wide as the eye can see.

You can see an old sign here.

* * *

>s
First path
As you move deeper into the forest, you can see a tree-lined path that splits left and right. There is a carving in the middle of a giant tree, barely noticeable.

>s
You can't go that way.

>w
Dreams
You find yourself in another clearing of the forest, but the trees around you appear to be violet in color. There is a clear stream in the middle of the clearing through which busy colorful fish swim. Small dragonflowers swaying in the trees emit a gentle light.

You can see Weeping Blue and a horned rabbit here.

* * *

>tell joke to old lady
You tell the old lady a knock knock joke, and she bawls from laughter. As reward, you're given a cookie from her basket.

>inventory
You are carrying:
  a cookie
  a duck

>eat cookie
You ate the cookie. HP up!

>check hp
You currently have 20 HP.

>w
Calm Pond
A small pond, perfectly still. The sky is covered in white, unmoving clouds. There is a wooden platform next to the north of here. You see a young man sitting on said platform in the distance.

You can see a bucket here.

>take bucket
Taken.

* * *

>catch duck
You want to take the duck by force, so the duck uses its force back.
You lost 5 HP!

>catch duck
You want to take the duck by force, so the duck uses its force back.
You lost 5 HP!

>check hp
You currently have 10 HP.

* * *

>w
You can't go that way.

>e
Hidden Cave
A small dark cave. You hear drops of water slowly fall to the watery ground beneath you. It's surprisingly cold for such a small space.

You can see a duck here.

>catch duck
You want to take the duck by force, so the duck uses its force back.
You lost 10 HP!

>check hp
You currently have 20 HP.

>w
Clearing
It's dark and foggy, so you don't see much. There's dark grass bluish in color from the light emitted by the few fireflies swirling around you. Trees as far and wide as the eye can see.

You can see an old sign here.

* * *

>w
Dreams
You find yourself in another clearing of the forest, but the trees around you appear to be violet in color. There is a clear stream in the middle of the clearing through which busy colorful fish swim. Small dragonflowers swaying in the trees emit a gentle light.

You can see Weeping Blue and a horned rabbit here.

>s
Town Square
A large clearing in the forest populated by dozens of wooden houses giving off a cozy feeling. There's solid ground underneath your feet, and a large ceiling above your head. You can't make out the material it's made out of. There's large streetlamps to illuminate the path and a large fountain of clear water in the middle. Children are dnacing in a circle in the bag, a cat is meowing from a roof. People walk around, chat, look at you as you stand at the entrance. An imposing clock tower can be seen from the distance, almost reaching the white round drawing of a moon. The smell of wood and bakeries is overwhelming.

You can see Old lady, Gentleman, Lotty, Nutcracker, Fisherman, Polly and a purse here.

>tell joke to old lady
You tell the old lady a knock knock joke, and she bawls from laughter. As reward, you're given a cookie from her basket.

>n
Dreams
You find yourself in another clearing of the forest, but the trees around you appear to be violet in color. There is a clear stream in the middle of the clearing through which busy colorful fish swim. Small dragonflowers swaying in the trees emit a gentle light.

You can see Weeping Blue and a horned rabbit here.

* * *

>e
Diverging path
As you move deeper into the forest, you can see a tree-lined path that splits left and right. There is a carving in the middle of a giant tree, barely noticeable.

>n
Clearing
It's dark and foggy, so you don't see much. There's dark grass bluish in color from the light emitted by the few fireflies swirling around you. Trees as far and wide as the eye can see.

You can see an old sign here.

>e
Hidden Cave
A small dark cave. You hear drops of water slowly fall to the watery ground beneath you. It's surprisingly cold for such a small space.

You can see a duck here.

>take duck
The duck eyes the cookie you're carrying hungrily. You prepare to feed the bird, but it lunges at you and steals the cookie. You got the duck, but lost the cookie in the process.

* * *

>inventory
You are carrying:
  a duck

>w
Clearing
It's dark and foggy, so you don't see much. There's dark grass bluish in color from the light emitted by the few fireflies swirling around you. Trees as far and wide as the eye can see.

You can see an old sign here.

* * *

>s
Diverging path
As you move deeper into the forest, you can see a tree-lined path that splits left and right. There is a carving in the middle of a giant tree, barely noticeable.

>pet duck
You can only do that to something animate.

>w
Dreams
You find yourself in another clearing of the forest, but the trees around you appear to be violet in color. There is a clear stream in the middle of the clearing through which busy colorful fish swim. Small dragonflowers swaying in the trees emit a gentle light.

You can see Weeping Blue and a horned rabbit here.

* * *

>give duck to lotty
Lotty: Thank you so much! I've missed you so much...
Lotty hugs the duck close to her chest.
Lotty: Give this to my brother. I'm sure he will warm up to you.
You got a golden egg.

>inventory
You are carrying:
  a golden egg

>w
Tree-lined Path
A silent path. A few owls sit on the birch trees leading to the town square. The ceiling you've seen in the town square is nowhere to be seen, a thick white blanket covering the sky instead.

* * *

>w
Tavern
A lively place. A live band is performing is in the back, and dozens of people are gathered at tiny coffee tables, enjoying hot beverages.

You can see a black tea, chamomile tea, a slippery elm tea, Lars, Snowman, Dan, Ginny, Bugcatcher and Schoolteacher here.

>give golden egg to lars
Lars: So you've helped my sister, ey. In that case, you can go to the cellar north of here. There might be something in it for you.

>give golden egg to lars
Lars: So you've helped my sister, ey. In that case, you can go to the cellar north of here. There might be something in it for you.

>inventory
You are carrying:
  a golden egg

>n
Cellar RM0
A completely dark room with not an ounce of light if not for the lightbulb at the entrance. Your cellar starting point. There's a strong smell of moisture in the air, and you hear trickling of water from above. You can't see much.

>e
Cellar RM1
A completely dark room, same as the rest. There's a strong smell of moisture in the air, and you hear trickling of water from above. You can't see much.

>n
Cellar RM4
A completely dark room, same as the rest. There's a strong smell of moisture in the air, and you hear trickling of water from above. You can't see much. But you feel that you're close to something.

>n
Cellar RM5
A small room with a lightbulb attached to the ceiling, making the room somewhat visible. This room leads to no new rooms; you can exit to the south.

You can see a cardboard box (in which is a revive) here.

>take revive
Taken.

>inventory
You are carrying:
  a revive
  a golden egg

>s
Cellar RM4
A completely dark room, same as the rest. There's a strong smell of moisture in the air, and you hear trickling of water from above. You can't see much. But you feel that you're close to something.

>e
Cellar RM6
A completely dark room, same as the rest. There's a strong smell of moisture in the air, and you hear trickling of water from above. You can't see much. But you feel that you're close to something.

>n
Cellar RM7
A room lit by a single light bulb hanging from the ceiling. There's a strong smell of moisture in the air, and you hear trickling of water from above. This room smells of tea and condiments.

You can see a metal box (in which is a teleportation charm) here.

>take teleportation charm
Taken.

>look at teleportation charm
An item for instant teleportation to the forest clearing

>teleport
You use the charm to teleport yourself.

Clearing
It's dark and foggy, so you don't see much. There's dark grass bluish in color from the light emitted by the few fireflies swirling around you. Trees as far and wide as the eye can see.

You can see an old sign here.

>inventory
You are carrying:
  a teleportation charm
  a revive
  a golden egg

* * *

>s
Diverging path
As you move deeper into the forest, you can see a tree-lined path that splits left and right. There is a carving in the middle of a giant tree, barely noticeable.

* * *

>w
Dreams
You find yourself in another clearing of the forest, but the trees around you appear to be violet in color. There is a clear stream in the middle of the clearing through which busy colorful fish swim. Small dragonflowers swaying in the trees emit a gentle light.

You can see Weeping Blue and a horned rabbit here.

>show mirror to weeping blue
Weeping Blue takes the cracked mirror from your hands and looks at herself. She suddenly smiles a brilliant smile.
Thank you very much, boy. I finally remember. now I hope my necklace helps you in some way.

>e
First path
As you move deeper into the forest, you can see a tree-lined path that splits left and right. There is a carving in the middle of a giant tree, barely noticeable.

* * *

>w
Dreams
You find yourself in another clearing of the forest, but the trees around you appear to be violet in color. There is a clear stream in the middle of the clearing through which busy colorful fish swim. Small dragonflowers swaying in the trees emit a gentle light.

You can see Weeping Blue and a horned rabbit here.

>inventory
You are carrying:
  a mirror

>show mirror to weeping blue
Weeping Blue is unimpressed.

>show mirror to the weeping blue
Weeping Blue is unimpressed.

* * *

>show mirror to weeping blue
Weeping Blue takes the cracked mirror from your hands and looks at herself. She suddenly smiles a brilliant smile.
Thank you very much, boy. I finally remember. now I hope my necklace helps you in some way.

>show mirror to horned rabbit
You're not carrying one.

>e
First path
As you move deeper into the forest, you can see a tree-lined path that splits left and right. There is a carving in the middle of a giant tree, barely noticeable.

* * *

>w
Dreams
You find yourself in another clearing of the forest, but the trees around you appear to be violet in color. There is a clear stream in the middle of the clearing through which busy colorful fish swim. Small dragonflowers swaying in the trees emit a gentle light.

You can see Weeping Blue and a horned rabbit here.

>show mirror to horned rabbit
The horned rabbit is unimpressed.

>show mirror to weeping blue
Weeping Blue is unimpressed.

* * *

>show mirror to weeping blue
Weeping Blue takes the cracked mirror from your hands and looks at herself. She suddenly smiles a brilliant smile.
Thank you very much, boy. I finally remember. now I hope my necklace helps you in some way.

>inventory
You are carrying:
  a crystal teardrop

>show mirror to horned rabbit
the horned rabbit looks at the mirror, but doesn't do anything else.

>show teardrop to weeping blue
Weeping Blue is unimpressed.

>show teardrop to fish
You can only do that to something animate.

>show teardrop to horned rabbit
The horned rabbit is unimpressed.

* * *

>w
Dreams
You find yourself in another clearing of the forest, but the trees around you appear to be violet in color. There is a clear stream in the middle of the clearing through which busy colorful fish swim. Small dragonflowers swaying in the trees emit a gentle light.

You can see Weeping Blue and a horned rabbit here.

>show mirror
You can't see any such thing.

>show mirror to weeping blue
You can't see any such thing.

>show
Whom do you want to show?

>weeping blue
What do you want to show Weeping Blue?

>mirror
You can't see any such thing.

>n
You can't go that way.

>e
First path
As you move deeper into the forest, you can see a tree-lined path that splits left and right. There is a carving in the middle of a giant tree, barely noticeable.

* * *

>w
Dreams
You find yourself in another clearing of the forest, but the trees around you appear to be violet in color. There is a clear stream in the middle of the clearing through which busy colorful fish swim. Small dragonflowers swaying in the trees emit a gentle light.

You can see Weeping Blue and a horned rabbit here.

>show mirror
Whom do you want to show the mirror to?

>horned rabbit
the mirror looks at the mirror, but doesn't do anything else.

>show mirror
Whom do you want to show the mirror to?

>weeping blue
the mirror looks at the mirror, but doesn't do anything else.

* * *

>show mirror
You can't see any such thing.

>weeping blu
That's not a verb I recognise.

>weeping blue
That's not a verb I recognise.

>show mirror
You can't see any such thing.

>inventory
You are carrying nothing.

>e
First path
As you move deeper into the forest, you can see a tree-lined path that splits left and right. There is a carving in the middle of a giant tree, barely noticeable.

* * *

>n
Clearing
It's dark, so you don't see much. There's dark grass bluish in color from the light emitted by the few fireflies swirling around you. Trees as far and wide as the eye can see.

You can see an old sign here.

>w
Hidden Cave
A small dark cave. You hear drops of water slowly fall to the watery ground beneath you. It's surprisingly cold for such a small space.

You can see a duck and a breadloaf here.

>take mirror
You can't see any such thing.

>e
Clearing
It's dark, so you don't see much. There's dark grass bluish in color from the light emitted by the few fireflies swirling around you. Trees as far and wide as the eye can see.

You can see an old sign here.

>n
Treestump
A large treestump is lying vertically on the ground of the clearing. A few toadstools sit around it, acting as lamps.

You can see a flashlight, a mirror and a fishhook here.

* * *

>show mirror
Whom do you want to show the mirror to?

>horned rabbit
the mirror takes the cracked mirror from your hands and looks at herself. She suddenly smiles a brilliant smile.
Thank you very much, boy. I finally remember. now I hope my necklace helps you in some way.
In the back, the horned rabbit's eyes shine.

* * *

>show mirror
You can't see any such thing.

>e
First path
As you move deeper into the forest, you can see a tree-lined path that splits left and right. There is a carving in the middle of a giant tree, barely noticeable.

* * *

>n
Treestump
A large treestump is lying vertically on the ground of the clearing. A few toadstools sit around it, acting as lamps.

You can see a flashlight, a mirror and a fishhook here.

>n
You can't go that way.

>take mirror
Upon taking the cracked mirror, the other items magically disappear... You decide to go back.

Clearing
It's dark, so you don't see much. There's dark grass bluish in color from the light emitted by the few fireflies swirling around you. Trees as far and wide as the eye can see.

You can see an old sign here.

* * *

>show mirror
Whom do you want to show the mirror to?

>horned rabbit
Nothing special happens.

>show mirror
Whom do you want to show the mirror to?

>weeping blue
Weeping Blue takes the cracked mirror from your hands and looks at herself. She suddenly smiles a brilliant smile.
Thank you very much, boy. I finally remember. now I hope my necklace helps you in some way.
In the back, the horned rabbit's eyes shine.

>approach horned rabbit
You approached the rabbit!

>look at horned rabbit
A white horned rabbit, curiously looking your way. No matter what you do, it seems intent on following. Try approaching it!

>look at weeping blue
A blue-colored woman whose hair is a the color and shine of crystals with a beautiful necklace around her neck. She looks content and smiles at you

* * *

>w
Dreams
You find yourself in another clearing of the forest, but the trees around you appear to be violet in color. There is a clear stream in the middle of the clearing through which busy colorful fish swim. Small dragonflowers swaying in the trees emit a gentle light.

You can see Weeping Blue and a horned rabbit here.

>look at horned rabbit
A white horned rabbit, curiously looking your way. No matter what you do, it seems intent on following.It doesn't seem to want to be approached...

* * *

>w
Dreams
You find yourself in another clearing of the forest, but the trees around you appear to be violet in color. There is a clear stream in the middle of the clearing through which busy colorful fish swim. Small dragonflowers swaying in the trees emit a gentle light.

You can see Weeping Blue and a horned rabbit here.

>catch rabbit
You run after the horned rabbit and it starts fleeing. You follow the rabbit out of the clearing, landing in a new area.

Town Square
A large clearing in the forest populated by dozens of wooden houses giving off a cozy feeling. There's solid ground underneath your feet, and a large ceiling above your head. You can't make out the material it's made out of. There's large streetlamps to illuminate the path and a large fountain of clear water in the middle. Children are dnacing in a circle in the bag, a cat is meowing from a roof. People walk around, chat, look at you as you stand at the entrance. An imposing clock tower can be seen from the distance, almost reaching the yellow round drawing of a moon. The smell of wood and bakeries is overwhelming.

You can see Old lady, Gentleman, Lotty, Nutcracker, Fisherman, Polly and a purse here.

>look at fisherman
An old fisherman with a straw hat, despite there not being any sunlight. His hands are jittery as he holds a pole. He reminds you of your father.

>ask fisherman about what he is doing
There is no reply.

* * *

>check hp
You currently have 30 HP.

>tell joke to old lady
You tell the old lady a knock knock joke, and she bawls from laughter. As reward, you're given a cookie from her basket.

>tell joke to old lady
You tell the old lady a knock knock joke, and she bawls from laughter.

>inventory
You are carrying:
  a cookie

>eat cookie
You ate the cookie. HP up!

>check hp
You currently have 30 HP.

* * *

>tell joke to old lady
You tell the old lady a knock knock joke, and she bawls from laughter. As reward, you're given a cookie from her basket.

>e
Clock Tower
An ancient clock tower, made with brown stone and covered in ivies that climbed its walls for ages. Its tower reaches well into the man-made ceiling, the tip of it nearly touching the yellow drawing of the inexistant moon of this world. The hands of time seem to flow seamlessly into the wrong side. As you enter the building, you're met with an owl guard whose head turns into your diretion as your first footsteps echo through the marble-covered floor. To the north, you see a staircase that leads up the slim tower, seemingly leading into a circle as you climb the building. To the east, there is a dark entrance, something shining gleaming from behind it.

You can see Owl here.

>temporal hoot
The owl's eyes widen and it hoots. The clock behind it shows time ticking in the right direction again.

>n
The owl lets you through.

Bell Tower
The climb up the stairs is arduous and dizzying. Something doesn't feel quite right as you ascend the endless tower. But then you exit, and a gust of harsh wind blows into your face. You find yourself at the top of the tower, right below the glowing painted moon. In front of you, there is a giant bell, filled with ancient reliefs and jewels, just ready to be rung. A fierce dragon stands in front of it protectively, asserting your intentions.

>ring bell
The dragon suddely attacked! You have to defeat it before you can ring the bell! You can either attack, defend, or use consumables!

* * *

>tell joke to old lady
You tell the old lady a knock knock joke, and she bawls from laughter. As reward, you're given a cookie from her basket.

* * *

>n
The owl lets you through.

Bell Tower
The climb up the stairs is arduous and dizzying. Something doesn't feel quite right as you ascend the endless tower. But then you exit, and a gust of harsh wind blows into your face. You find yourself at the top of the tower, right below the glowing painted moon. In front of you, there is a giant bell, filled with ancient reliefs and jewels, just ready to be rung. A fierce dragon stands in front of it protectively, asserting your intentions.

>ring bell
The dragon suddely attacked! You have to defeat it before you can ring the bell! You can either attack, defend from dragon, or use consumables!

>defend from dragon
You defend from the dragon's next attack. You gain temporary 5 defense!

DRAGON'S TURN
The dragon heals its wounds. It regained 5 HP!

>defend from dragon
You defend from the dragon's next attack. You gain temporary 5 defense!

DRAGON'S TURN
The dragon blows fire! You lost 10 HP!

>check hp
You currently have 20 HP.

>attack
(the cookie)
You don't attack the cookie.

>attack dragon
You swing at the dragon with all your might! The dragon takes 5 damage!

DRAGON'S TURN
The dragon heals its wounds. It regained 5 HP!

>attack dragon
You swing at the dragon with all your might! The dragon takes 5 damage!

DRAGON'S TURN
The dragon has to recharge and does nothing this turn.

>attack dragon
You swing at the dragon with all your might! The dragon takes 5 damage!

DRAGON'S TURN
The dragon blows fire! You lost 15 HP!

    *** You've lost all your HP! You're unable to continue your journey. ***

Would you like to RESTART, RESTORE a saved game, QUIT or UNDO the last command?

>undo
Bell Tower
[Previous turn undone.]

>check hp
You currently have 13 HP.

>eat cookie
You ate the cookie. HP up!

DRAGON'S TURN
The dragon swings its claws at you! You lost 10 HP!

>check hp
You currently have 8 HP.

>attack
(the dragon)
You swing at the dragon with all your might! The dragon takes 5 damage!

DRAGON'S TURN
The dragon swings its claws at you! You lost 10 HP!

    *** You've lost all your HP! You're unable to continue your journey. ***

Would you like to RESTART, RESTORE a saved game, QUIT or UNDO the last command?

>restart
"Welcome to the world of wishes", an ominous voice calls from afar. You stirr in your sleep and wake up, only to find yourself on cold grass - you don't remember falling asleep here. You look around you, only to realize you are in the midst of a forest clearing. It's horribly foggy, but strangely warm.

WishFish
An Interactive Fiction by Elena Krzina
Release 1 / Serial number 230101 / Inform 7 build 6M62 (I6/v6.33 lib 6/12N) SD

Clearing
It's dark and foggy, so you don't see much. There's dark grass bluish in color from the light emitted by the few fireflies swirling around you. Trees as far and wide as the eye can see.

You can see an old sign here.

* * *

>ring bell
The dragon suddely attacked! You have to defeat it before you can ring the bell! You can either attack, defend from dragon, or use consumables!

>attack dragon
You swing at the dragon with all your might! The dragon takes 10 damage!

DRAGON'S TURN
The dragon heals its wounds. It regained 5 HP!

>attack dragon
You swing at the dragon with all your might! The dragon takes 10 damage!

DRAGON'S TURN
The dragon blows fire! You lost 15 HP!

>eat cookie
You ate the cookie. HP up!

DRAGON'S TURN
The dragon has to recharge and does nothing this turn.

>attack dragon
You swing at the dragon with all your might! The dragon takes 10 damage!

DRAGON'S TURN
The dragon has to recharge and does nothing this turn.

>check hp
You currently have 6 HP.

>attack
(the dragon)
You swing at the dragon with all your might! The dragon takes 10 damage!
The dragon is defeated! It bows to you and clears the way to the bell.

DRAGON'S TURN
The dragon swings its claws at you! You lost 10 HP!

    *** You've lost all your HP! You're unable to continue your journey. ***

Would you like to RESTART, RESTORE a saved game, QUIT or UNDO the last command?

>undo
Bell Tower
[Previous turn undone.]

>attack dragon
You swing at the dragon with all your might! The dragon takes 10 damage!
The dragon is defeated! It bows to you and clears the way to the bell.

DRAGON'S TURN
The dragon swings its claws at you! You lost 10 HP!

    *** You've lost all your HP! You're unable to continue your journey. ***

Would you like to RESTART, RESTORE a saved game, QUIT or UNDO the last command?

* * *

>e
Clock Tower
An ancient clock tower, made with brown stone and covered in ivies that climbed its walls for ages. Its tower reaches well into the man-made ceiling, the tip of it nearly touching the yellow drawing of the inexistant moon of this world. The hands of time seem to flow seamlessly into the wrong side. As you enter the building, you're met with an owl guard whose head turns into your direction as your first footsteps echo through the marble-covered floor. To the north, you see a staircase that leads up the slim tower, seemingly leading into a circle as you climb the building. To the east, there is a dark entrance, something shining gleaming from behind it.

You can see Owl here.

* * *

>temporal hoot
The owl's eyes widen and it hoots.

>n
The owl lets you through.

Bell Tower
The climb up the stairs is arduous and dizzying. Something doesn't feel quite right as you ascend the endless tower. But then you exit, and a gust of harsh wind blows into your face. You find yourself at the top of the tower, right below the glowing painted moon. In front of you, there is a giant bell, filled with ancient reliefs and jewels, just ready to be rung. A fierce dragon stands in front of it protectively, asserting your intentions.

* * *

>ring bell
The dragon suddely attacked! You have to defeat it before you can ring the bell! You can either attack, defend from dragon, or use consumables!

>attack dragon
You swing at the dragon with all your might! The dragon takes 40 damage!

DRAGON'S TURN
The dragon blows fire! You lost 15 HP!

>attack dragon
You swing at the dragon with all your might! The dragon takes 40 damage!
The dragon is defeated! It bows to you and clears the way to the bell.

DRAGON'S TURN
The dragon heals its wounds. It regained 5 HP!

>ring bell
The dragon bows its head.
You rang the bell. It's soothing sound echoes through the area... Oh? But what's this? Something seems to have fallen out of it as you rung it.
You obtained the shiny key!

* * *

>ring bell
The dragon suddely attacked! You have to defeat it before you can ring the bell! You can either attack, defend from dragon, or use consumables!

>check hp
You currently have 30 HP.

>attack
(the dragon)
You swing at the dragon with all your might! The dragon takes 10 damage!

DRAGON'S TURN
The dragon has to recharge and does nothing this turn.

>check hp
You currently have 23 HP.

* * *

>n
The owl lets you through.

Bell Tower
The climb up the stairs is arduous and dizzying. Something doesn't feel quite right as you ascend the endless tower. But then you exit, and a gust of harsh wind blows into your face. You find yourself at the top of the tower, right below the glowing painted moon. In front of you, there is a giant bell, filled with ancient reliefs and jewels, just ready to be rung. A fierce dragon stands in front of it protectively, asserting your intentions.

>n
You can't go that way.

>ring bell
The dragon suddely attacked! You have to defeat it before you can ring the bell! You can either attack, defend from dragon, or use consumables!

>attack
(the dragon)
You swing at the dragon with all your might! The dragon takes 10 damage!

DRAGON'S TURN
The dragon heals its wounds. It regained 5 HP!

>check hp
You currently have 30 HP.

>attack
(the dragon)
You swing at the dragon with all your might! The dragon takes 10 damage!

DRAGON'S TURN
The dragon heals its wounds. It regained 5 HP!

>attack
(the dragon)
You swing at the dragon with all your might! The dragon takes 10 damage!

DRAGON'S TURN
The dragon swings its claws at you! You lost 10 HP!

>check hp
You currently have 20 HP.

>attack
(the dragon)
You swing at the dragon with all your might! The dragon takes 10 damage!

DRAGON'S TURN
The dragon heals its wounds. It regained 5 HP!

* * *

>attack
(the dragon)
You swing at the dragon with all your might! The dragon takes 10 damage!

DRAGON'S TURN
The dragon swings its claws at you! You lost 10 HP!

>attack
(the dragon)
You swing at the dragon with all your might! The dragon takes 10 damage!

DRAGON'S TURN
The dragon blows fire! You lost 15 HP!

    *** You've lost all your HP! You're unable to continue your journey. ***

Would you like to RESTART, RESTORE a saved game, QUIT or UNDO the last command?

>restart
"Welcome to the world of wishes", an ominous voice calls from afar. You stirr in your sleep and wake up, only to find yourself on cold grass - you don't remember falling asleep here. You look around you, only to realize you are in the midst of a forest clearing. It's horribly foggy, but strangely warm.

WishFish
An Interactive Fiction by Elena Krzina
Release 1 / Serial number 230101 / Inform 7 build 6M62 (I6/v6.33 lib 6/12N) SD

Clearing
It's dark and foggy, so you don't see much. There's dark grass bluish in color from the light emitted by the few fireflies swirling around you. Trees as far and wide as the eye can see.

You can see an old sign here.

>s
Diverging path
As you move deeper into the forest, you can see a tree-lined path that splits left and right. There is a carving in the middle of a giant tree, barely noticeable.

* * *

>w
Dreams
You find yourself in another clearing of the forest, but the trees around you appear to be violet in color. There is a clear stream in the middle of the clearing through which busy colorful fish swim. Small dragonflowers swaying in the trees emit a gentle light.

You can see Weeping Blue and a horned rabbit here.

>e
Diverging path
As you move deeper into the forest, you can see a tree-lined path that splits left and right. There is a carving in the middle of a giant tree, barely noticeable.

* * *

>n
Clearing
It's dark and foggy, so you don't see much. There's dark grass bluish in color from the light emitted by the few fireflies swirling around you. Trees as far and wide as the eye can see.

You can see an old sign here.

>n
Treestump
A large treestump is lying vertically on the ground of the clearing. A few toadstools sit around it, acting as lamps.

You can see a flashlight, a mirror and a fishhook here.

>take flashlight
Upon taking the flashlight, the other items magically disappear... You decide to go back.

Clearing
It's dark and foggy, so you don't see much. There's dark grass bluish in color from the light emitted by the few fireflies swirling around you. Trees as far and wide as the eye can see.

You can see an old sign here.

>s
Diverging path
As you move deeper into the forest, you can see a tree-lined path that splits left and right. There is a carving in the middle of a giant tree, barely noticeable.

* * *

>help fisherman tie hook
You tie the fisherman's hook to the pole with a smile. The fisherman gives you 20 gems as compensation, which you politely decline. But the fisherman stuffs them into your hand nevertheless.

>tell joke to old lady
You tell the old lady a knock knock joke, and she bawls from laughter. As reward, you're given a cookie from her basket.

* * *

>take duck
The duck eyes the cookie you're carrying hungrily. You prepare to feed the bird, but it lunges at you and steals the cookie. You got the duck, but lost the cookie in the process.

>inventory
You are carrying:
  a duck
  a flashlight

>w
Clearing
It's dark and foggy, so you don't see much. There's dark grass bluish in color from the light emitted by the few fireflies swirling around you. Trees as far and wide as the eye can see.

You can see an old sign here.

* * *

>take purse
Before you could pick up the purse, the gentleman wearing that ridiculously large tophat you saw at the entrance stops you and bows to you.
Gentleman: What are you doing, young sir? You are in no way entitled to this woman's purse. Run along, now.
You decide to leave the purse where it is.

>give duck to lotty
Lotty: Thank you so much! I've missed you so much...
Lotty hugs the duck close to her chest.
Lotty: Give this to my brother. I'm sure he will warm up to you.
You got a golden egg.

>ask lotty about the dragon
There is no reply.

>ask lotty about dragon
Lotty: The dragon sleeps at the bottom of the clock tower and needs only a swing of its wings to climb the tower.
Lotty: But in the off chance that it attacks you... Maybe this will help!
Lotty produces an omelette out of her basket and shoves it into your hands clumsily.

>ask lotty about dragon
Lotty: The dragon sleeps at the bottom of the clock tower and needs only a swing of its wings to climb the tower.
Lotty: Cooking is something I really enjoy. But I only had one with me today. Sorry!

>inventory
You are carrying:
  an omelette
  a golden egg
  a flashlight

>tell joke to old lady
You tell the old lady a knock knock joke, and she bawls from laughter. As reward, you're given a cookie from her basket.

>w
Tree-lined Path
A silent path. A few owls sit on the birch trees leading to the town square. The ceiling you've seen in the town square is nowhere to be seen, a thick white blanket covering the sky instead.

* * *

>give bucket to murmur
The young man extends his hand to take the item. He nods curtly, then fastens one of the worms to the hook. You'll never like the sight of it.

>ask murmur about father
There is no reply.

>ask murmur about how his father came to wish world
There is no reply.

>ask murmur about how his father came to world of wishes
He went... fishing one day. Then disappeared. It was just me and my father, back then. When he didn't come back, I...
He winces.
I found his straw hat the same day, near the lake where he would fish every day. But there was no sign of him. For a year. He always wished for a change... I gave up evetually. Just continued fishing by the lake.
Your head starts to hurt. You want to remember... You feel a surge of power! Increased attack by 2.

>try to remember
That's not a verb I recognise.

>remember
I didn't understand that sentence.

>remember what happened
You're still getting dizzy as you try to remember. There was a storm. You're sure of it.

* * *

>n
The owl lets you through.

Bell Tower
The climb up the stairs is arduous and dizzying. Something doesn't feel quite right as you ascend the endless tower. But then you exit, and a gust of harsh wind blows into your face. You find yourself at the top of the tower, right below the glowing painted moon. In front of you, there is a giant bell, filled with ancient reliefs and jewels, just ready to be rung. A fierce dragon stands in front of it protectively, asserting your intentions.

>s
Clock Tower
An ancient clock tower, made with brown stone and covered in ivies that climbed its walls for ages. Its tower reaches well into the man-made ceiling, the tip of it nearly touching the yellow drawing of the inexistant moon of this world. The hands of time seem to flow seamlessly into the wrong side. As you enter the building, you're met with an owl guard whose head turns into your direction as your first footsteps echo through the marble-covered floor. To the north, you see a staircase that leads up the slim tower, seemingly leading into a circle as you climb the building. To the east, there is a dark entrance, something shining gleaming from behind it.

You can see Owl here.

* * *

>e
The owl's feathers ruffle, but it remains still.

Treasury
A large open room filled with the brim with gold coins and gems. A monster sleeps on top of it all, snoring contently. There's a note here.

>deposit gems
You don't think that'll be enough.

>w
Clock Tower
An ancient clock tower, made with brown stone and covered in ivies that climbed its walls for ages. Its tower reaches well into the man-made ceiling, the tip of it nearly touching the yellow drawing of the inexistant moon of this world. The hands of time seem to flow seamlessly into the wrong side. As you enter the building, you're met with an owl guard whose head turns into your direction as your first footsteps echo through the marble-covered floor. To the north, you see a staircase that leads up the slim tower, seemingly leading into a circle as you climb the building. To the east, there is a dark entrance, something shining gleaming from behind it.

You can see Owl here.

* * *

>ring bell
The dragon suddely attacked! You have to defeat it before you can ring the bell! You can either attack, defend from dragon, or use consumables!

>s
You can't run from the dragon!

>attack dragon
You swing at the dragon with all your might! The dragon takes 5 damage!

DRAGON'S TURN
The dragon blows fire! You lost 15 HP!

>defend from dragon
You defend from the dragon's next attack. You gain temporary 5 defense!

DRAGON'S TURN
The dragon has to recharge and does nothing this turn.

>attack dragon
You swing at the dragon with all your might! The dragon takes 5 damage!

DRAGON'S TURN
The dragon blows fire! You lost 15 HP!

    *** You've lost all your HP! You're unable to continue your journey. ***

Would you like to RESTART, RESTORE a saved game, QUIT or UNDO the last command?

>restart
"Welcome to the world of wishes", an ominous voice calls from afar. You stirr in your sleep and wake up, only to find yourself on cold grass - you don't remember falling asleep here. You look around you, only to realize you are in the midst of a forest clearing. It's horribly foggy, but strangely warm.

WishFish
An Interactive Fiction by Elena Krzina
Release 1 / Serial number 230107 / Inform 7 build 6M62 (I6/v6.33 lib 6/12N) SD

Clearing
It's dark and foggy, so you don't see much. There's dark grass bluish in color from the light emitted by the few fireflies swirling around you. Trees as far and wide as the eye can see. There's an old sign here.

>reach for gold
Can't do that here.

* * *

>e
The owl's feathers ruffle, but it remains still.

Treasury
A large open room filled with the brim with gold coins and gems. A monster sleeps on top of it all, snoring contently. There's a note here.

>look at note
You can't see any such thing.

* * *

>e
The owl's feathers ruffle, but it remains still.

Treasury
A large open room filled with the brim with gold coins and gems. A monster sleeps on top of it all, snoring contently. There's a note here.

>look at npte
You can't see any such thing.

>look at note
"The dragon blesses those who deposit a large sum of gems. Profits go to dragons. Will be guarded safely for all enternity." Or so the sign says.

* * *

>w
Tree-lined Path
A silent path. A few owls sit on the birch trees leading to the town square. The ceiling you've seen in the town square is nowhere to be seen, a thick white blanket covering the sky instead.

* * *

>take black tea
Taken.

>e
You're carrying an order!

>look
Tavern
A lively place. A live band is performing is in the back, and dozens of people are gathered at tiny coffee tables, enjoying hot beverages.

You can see chamomile tea, a slippery elm tea, Lars, Snowman, Dan, Ginny, Bugcatcher and Schoolteacher here.

>take chamomile tea
Taken.

>e
You're carrying an order!

>give chamomile tea to schoolteacher
Schoolteacher: Ah! Most wonderous!
The schoolteacher downs the tea.

>e
You're carrying an order!

>give black tea to ginny
Ginny: Yes. That's my order, thank you.

>e
Yard
A small yard leading to a cozy wooden tavern just west of here.

You can see Large Bear here.

>w
Tavern
A lively place. A live band is performing is in the back, and dozens of people are gathered at tiny coffee tables, enjoying hot beverages.

You can see a slippery elm tea, Lars, Snowman, Dan, Ginny, Bugcatcher and Schoolteacher here.

>take slippery elm tea
Taken.

>e
You're carrying an order!

>give slippery elm tea to dan
Dan: Ah, yes! My order! Thanks! I can continue talking in peace now.

>e
Yard
A small yard leading to a cozy wooden tavern just west of here.

You can see Large Bear here.

* * *

>w
Dreams
You find yourself in another clearing of the forest, but the trees around you appear to be violet in color. There is a clear stream in the middle of the clearing through which busy colorful fish swim. Small dragonflowers swaying in the trees emit a gentle light.

You can see Weeping Blue and a horned rabbit here.

>s
You're not sure how to proceed...

>ask fisherman about what he is doing
Fisherman: I am trying to attach my hook to the pole, but I'm afraid these hands aren't as deft as they used to be.
The man struggles to attach the hook onto his pole. His ham hands can't quite make a tie as small as that.

>help fisherman tie hook
You tie the fisherman's hook to the pole with a smile. The fisherman gives you 20 gems as compensation, which you politely decline. But the fisherman stuffs them into your hand nevertheless.

>check gem collection
You can't see any such thing.

>check gems
You currently have 20 gems.

>help fisherman tie hook
You've already helped him out.

>check gems
You currently have 20 gems.

* * *

>s
You're not sure how to proceed...

>help fisherman tie hook
You tie the fisherman's hook to the pole with a smile. The fisherman gives you 20 gems as compensation, which you politely decline. But the fisherman stuffs them into your hand nevertheless.

>look at fisherman
An old fisherman with a straw hat, despite there not being any sunlight. His hands are jittery as he holds a pole. He reminds you of your father.

>ask fisherman what he is doing
I didn't understand that sentence.

>ask fisherman about what he is doing
Fisherman: Just preparing for a trip, young man.
The man smiles gently at you.

* * *

>s
You're not sure how to proceed...

>w
Tree-lined Path
A silent path. A few owls sit on the birch trees leading to the town square. The ceiling you've seen in the town square is nowhere to be seen, a thick white blanket covering the sky instead.

>n
Wooden Platform
A simple wooden platform for fishermen to sit at and put their belongings on.

You can see Murmur here.

>look at murmur
A young man looking listlessly into the pond. Even the sounds of your footsteps don't stirr him from his thoughts. It's a familiar sight.

>ask murmur about him
There is no reply.

* * *

>n
Wooden Platform
A simple wooden platform for fishermen to sit at and put their belongings on.

You can see Murmur here.

>ask murmur about him
The man gave no response.

>s
Calm Pond
A small pond, perfectly still. The sky is covered in white, unmoving clouds. There is a wooden platform next to the north of here. You see a young man sitting on said platform in the distance.

>s
You can't go that way.

>e
Town Square
You can see Old lady, Gentleman, Curious boy, Nutcracker, Fisherman, Polly and a purse here.

>help fisherman tie hook
You tie the fisherman's hook to the pole with a smile. The fisherman gives you 20 gems as compensation, which you politely decline. But the fisherman stuffs them into your hand nevertheless.

>help fisherman tie hook
You've already helped him out.

>w
Calm Pond
A small pond, perfectly still. The sky is covered in white, unmoving clouds. There is a wooden platform next to the north of here. You see a young man sitting on said platform in the distance.

* * *

>s
Calm Pond
A small pond, perfectly still. The sky is covered in white, unmoving clouds. There is a wooden platform next to the north of here. You see a young man sitting on said platform in the distance.

>take bucket
You can't see any such thing.

* * *

>ask murmur about him
The man gave no response.

>ask murmur about his father
The man looks to you, but doesn't elaborate.

>ask murmur about his fisherman
There is no reply.

>ask murmur about fisherman
The man gave no response.

>ask murmur about what he is doing
The man gave no response.

>ask murmur about how his father came to the dream world
The man gave no response.

>ask murmur about real world
The man's eyes are wide as he turns to you. He doesn't elaborate.

>ask murmur about how he came to this world
The man gave no response.

>ask murmur about fish
The man gave no response.

>s
Calm Pond
A small pond, perfectly still. The sky is covered in white, unmoving clouds. There is a wooden platform next to the north of here. You see a young man sitting on said platform in the distance.

You can see a bucket here.

>take bucket
Taken.

* * *

>n
Wooden Platform
A simple wooden platform for fishermen to sit at and put their belongings on.

You can see Murmur here.

>give bucket to murmur
The young man extends his hand to take the item. He nods curtly, then fastens one to the hook.

>ask murmur about him
There's not much to me. I haven't heard of you, too.

>ask murmur about his father
Yes, my father is a fisherman. He's been so since forever.
..

>s
Calm Pond
A small pond, perfectly still. The sky is covered in white, unmoving clouds. There is a wooden platform next to the north of here. You see a young man sitting on said platform in the distance.

>e
Town Square
You can see Old lady, Gentleman, Curious boy, Nutcracker, Fisherman, Polly and a purse here.

* * *

>help fisherman tie hook
You tie the fisherman's hook to the pole with a smile. The fisherman gives you 20 gems as compensation, which you politely decline. But the fisherman stuffs them into your hand nevertheless.

>w
Calm Pond
A small pond, perfectly still. The sky is covered in white, unmoving clouds. There is a wooden platform next to the north of here. You see a young man sitting on said platform in the distance.

* * *

>n
Wooden Platform
A simple wooden platform for fishermen to sit at and put their belongings on.

You can see Murmur here.

>ask murmur about him
There's not much to me. My father mentioned you. You're Stef, right?

>ask murmur about his father
Yes, my father is a fisherman. He's been so since forever.
 He means a lot to me.

>ask murmur about fisherman
I am one.

>ask murmur about what he is doing
Fishing.

>ask murmur about how his father came to the dream world
He went... fishing one day. Then disappeared. It was just me and my father, back then. When he didn't come back, I...
He winces.
I found his straw hat the same day, near the lake where he would fish every day. But there was no sign of him. For a year. I gave up evetually. Just continued fishing by the lake.

>try to remember
That's not a verb I recognise.

>try to remember what happened
That's not a verb I recognise.

>remember what happened
When you try to remember what happened, you suddenly get very dizzy. Nothing comes to mind, however.

>ask murmur about real world
The man's eyes are wide as he turns to you. He doesn't elaborate.

>ask murmur about fish
I release all the fish I catch. The pond would be empty by now, otherwise.

>ask murmur about how he came to this world
The man - very suddenly, might you add - bursts into loud laughter. He looks to you.
I can't tell you everything, can I?

* * *

>n
Wooden Platform
A simple wooden platform for fishermen to sit at and put their belongings on.

You can see Murmur here.

>check gems
You currently have 0 gems.

>play rock for murmur
ROCK.
Murmur: Nothing.

>check gems
You currently have 0 gems.

* * *

>play rock for murmur
ROCK.
Murmur: Nothing.

>play rock for murmur
PAPER.
Murmur: A win.

>play rock for murmur
ROCK.
Murmur: Nothing.

>play scissors for murmur
ROCK.
Murmur: A win.

>play scissors for murmur
SCISSORS.
Murmur: Nothing.

>play scissors for murmur
SCISSORS.
Murmur: Nothing.

>play scissors for murmur
PAPER.
Murmur: I lose.
Murmur gives you 5 gems as a prize.

>check gems
You currently have 5 gems.

>play rock for murmur
SCISSORS.
Murmur: I lose.

>check gems
You currently have 5 gems.

>e
You can't go that way.

>s
Calm Pond
A small pond, perfectly still. The sky is covered in white, unmoving clouds. There is a wooden platform next to the north of here. You see a young man sitting on said platform in the distance.

You can see a bucket here.

>e
Town Square
You can see Old lady, Gentleman, Curious girl, Nutcracker, Fisherman, Polly and a purse here.

>play rock for polly
PAPER!
Polly: You lose! You lose!

* * *

>play rock for polly
SCISSORS!
Polly: I lost?!
Polly gives you a gem.

>play rock for polly
ROCK!
Polly: Draw!

* * *

>play rock for polly
SCISSORS!
Polly: I lost?!
Polly gives you a gem.

>check gems
You currently have 8 gems.

>play scissors for polly
PAPER!
Polly: I lost?!
Polly gives you a gem.

>play scissors for polly
ROCK!
Polly: You lose! You lose!

>play scissors for polly
SCISSORS!
Polly: Draw!

>play scissors for polly
ROCK!
Polly: You lose! You lose!

>play scissors for polly
ROCK!
Polly: You lose! You lose!

>play scissors for polly
PAPER!
Polly: I lost?!
Polly gives you a gem.

>check gems
You currently have 10 gems.

>play paper for polly
ROCK!
Polly: I lost?!

>check gems
You currently have 10 gems.

>w
Calm Pond
A small pond, perfectly still. The sky is covered in white, unmoving clouds. There is a wooden platform next to the north of here. You see a young man sitting on said platform in the distance.

You can see a bucket here.

>n
Wooden Platform
A simple wooden platform for fishermen to sit at and put their belongings on.

You can see Murmur here.

>play paper for murmur
SCISSORS.
Murmur: A win.

>play paper for murmur
ROCK.
Murmur: I lose. Never got how paper beats rock.

>check gems
You currently have 10 gems.

* * *

>n
Wooden Platform
A simple wooden platform for fishermen to sit at and put their belongings on.

You can see Murmur here.

>tell joke to murmur
He doesn't seem interested in your joke.

>s
Calm Pond
A small pond, perfectly still. The sky is covered in white, unmoving clouds. There is a wooden platform next to the north of here. You see a young man sitting on said platform in the distance.

You can see a bucket here.

* * *

>give bucket to murmur
The young man extends his hand to take the item. He nods curtly, then fastens one of the worms to the hook. You'll never like the sight of it.

>tell joke to murmur
Murmur offers a weak smile. It's not reassuring.

>look at cookie
You can't see any such thing.

* * *

>w
Tree-lined Path
A silent path. A few owls sit on the birch trees leading to the town square. The ceiling you've seen in the town square is nowhere to be seen, a thick white blanket covering the sky instead.

>take bucket
Taken.

* * *

>n
Wooden Platform
A simple wooden platform for fishermen to sit at and put their belongings on.

You can see Murmur here.

>s
Calm Pond
A small pond, perfectly still. The sky is covered in white, unmoving clouds. There is a wooden platform next to the north of here. You see a young man sitting on said platform in the distance.

* * *

>e
Town Square
You can see Old lady, Gentleman, Curious boy, Nutcracker, Fisherman, Polly and a purse here.

>give bucket to old lady
bucket doesn't want the bucket.

>inventory
You are carrying:
  a bucket

>w
Calm Pond
A small pond, perfectly still. The sky is covered in white, unmoving clouds. There is a wooden platform next to the north of here. You see a young man sitting on said platform in the distance.

* * *

>ask murmur about him
The man gave no response.

>give bucket to murmur
The young man extends his hand to take the item. He nods curtly, then fastens one to the hook.

>inventory
You are carrying nothing.

>ask murmur about him
The man gave no response.

* * *

>give bucket to murmur
The young man extends his hand to take the item. He nods curtly, then fastens one of the worms to the hook. You'll never like the sight of it.

>ask murmur about him
There's not much to me. I haven't heard of you, too.

>s
Calm Pond
A small pond, perfectly still. The sky is covered in white, unmoving clouds. There is a wooden platform next to the north of here. You see a young man sitting on said platform in the distance.

* * *

>ask murmur about him
There's not much to me. My father mentioned you. You're Stef, right?

>inventory
You are carrying nothing.

* * *

>give bucket to murmur
The young man extends his hand to take the item. He nods curtly, then fastens one of the worms to the hook. You'll never like the sight of it.

>ask murmur about his father
Yes, my father is a fisherman. He's been so since forever.

>ask murmur about how his father got to the dream world
There is no reply.

>ask murmur about how his father came to the dream world
He went... fishing one day. Then disappeared. It was just me and my father, back then. When he didn't come back, I...
He winces.
I found his straw hat the same day, near the lake where he would fish every day. But there was no sign of him. For a year. I gave up evetually. Just continued fishing by the lake.
Your head starts to hurt. You want to remember...

>remember what happened
You're still getting dizzy as you try to remember. There was a storm. You're sure of it.

>s
Calm Pond
A small pond, perfectly still. The sky is covered in white, unmoving clouds. There is a wooden platform next to the north of here. You see a young man sitting on said platform in the distance.

>e
Town Square
You can see Old lady, Gentleman, Curious girl, Nutcracker, Fisherman, Polly and a purse here.

>n
Dreams
You find yourself in another clearing of the forest, but the trees around you appear to be violet in color. There is a clear stream in the middle of the clearing through which busy colorful fish swim. Small dragonflowers swaying in the trees emit a gentle light.

You can see Weeping Blue and a horned rabbit here.

>look at fish
Very buys-looking red fish. They swim through the stream rather quickly, and you can't make out anything else other than fish. You would jump into water to scare them off, were you not deathly afraid of the fish swimming in the stream in the first place. Something golden shimmers in the water.

>reach for gold
You reach for the golden object shimmering in the stream, but your head suddenly starts to hurt horribly, stopping you in your action.
You want to remember...

>reach for gold
You suddenly remember - you're scared of fish! You won't be reaching into that stream any time soon!

>reach for gold
You suddenly remember - you're scared of fish! You won't be reaching into that stream any time soon!

>remember what happened
You're still getting dizzy as you try to remember. There was a storm. And something golden in it. You're sure of it.

* * *

>w
Tree-lined Path
A silent path. A few owls sit on the birch trees leading to the town square. The ceiling you've seen in the town square is nowhere to be seen, a thick white blanket covering the sky instead.

>e
Town Square
You can see Old lady, Gentleman, Curious boy, Nutcracker, Fisherman, Polly and a purse here.

* * *

>help fisherman tie hook
You tie the fisherman's hook to the pole with a smile. The fisherman gives you 20 gems as compensation, which you politely decline. But the fisherman stuffs them into your hand nevertheless.

>ask fisherman
What do you want to ask Fisherman for?

>about real world
You can't see any such thing.

>ask fisherman about real world
Fisherman: Don't remember much. I wished for a change, and found myself here. Dunno how at this point. You should ask my son, if you come by him.

>w
Calm Pond
A small pond, perfectly still. The sky is covered in white, unmoving clouds. There is a wooden platform next to the north of here. You see a young man sitting on said platform in the distance.

You can see a bucket here.

* * *

>take bucket
Taken.

>remember what happened
When you try to remember what happened, you suddenly get very dizzy. Nothing comes to mind, however.

>give bucket to murmur
You can't see any such thing.

>n
Wooden Platform
A simple wooden platform for fishermen to sit at and put their belongings on.

You can see Murmur here.

* * *

>give bucket to murmur
The young man extends his hand to take the item. He nods curtly, then fastens one to the hook.

>ask murmur about fish
I release all the fish I catch. The pond would be empty by now, otherwise.

* * *

>ask murmur about how he came to this world
The man - very suddenly, might you add - bursts into loud laughter. He looks to you.
I can't tell you everything, can I?

>ask murmur about how his father came to the dream world
He went... fishing one day. Then disappeared. It was just me and my father, back then. When he didn't come back, I...
He winces.
I found his straw hat the same day, near the lake where he would fish every day. But there was no sign of him. For a year. I gave up evetually. Just continued fishing by the lake.
Your head starts to hurt. You want to remember...

>ask murmur about how his father came to the dream world
He went... fishing one day. Then disappeared. It was just me and my father, back then. When he didn't come back, I...
He winces.
I found his straw hat the same day, near the lake where he would fish every day. But there was no sign of him. For a year. I gave up evetually. Just continued fishing by the lake.

>remember what happened
You're still getting dizzy as you try to remember. There was a pond. You're sure of it.

>look at murmur
A young man looking listlessly into the pond. Even the sounds of your footsteps don't stirr him from his thoughts. He greets you with a simple wave.

* * *

>n
Wooden Platform
A simple wooden platform for fishermen to sit at and put their belongings on.

You can see Murmur here.

>s
Calm Pond
A small pond, perfectly still. The sky is covered in white, unmoving clouds. There is a wooden platform next to the north of here. You see a young man sitting on said platform in the distance.

You can see a bucket here.

>w
Tavern Yard
A small yard leading to a cozy wooden tavern.

You can see Large Bear here.

>w
Tavern Yard
A small yard leading to a cozy wooden tavern.

You can see Large Bear here.

* * *

>w
You can't go that way.

>e
Yard
A small yard leading to a cozy wooden tavern just west of here.

You can see Large Bear here.

>look at large bear
A large, large bear with a flower tucked behind its ear. It's growling.

* * *

>w
Tavern
A lively place. A live band is performing is in the back, and dozens of people are gathered at tiny coffee tables, enjoying hot beverages.

You can see a black tea, chamomile tea, a slippery elm tea, Lars, Snowman, Dan, Ginny, Bugcatcher and Schoolteacher here.

>ask lars about him
Lars: There's nothing to me, kid. I sell tea and own this place. If you'd like to buy some, just ask me to make you one. It'll cost 15 gems. The world ain't for free.

>ask lars about making tea
Lars: You don't have enough to pay for it.

>e
Yard
A small yard leading to a cozy wooden tavern just west of here.

You can see Large Bear here.

* * *

>give bucket to murmur
The young man extends his hand to take the item. He nods curtly, then fastens one of the worms to the hook. You'll never like the sight of it.

>play rock for murmur
SCISSORS.
Murmur: I lose.
Murmur gives you 5 gems as a prize.

>s
Calm Pond
A small pond, perfectly still. The sky is covered in white, unmoving clouds. There is a wooden platform next to the north of here. You see a young man sitting on said platform in the distance.

>e
Tree-lined Path
A silent path. A few owls sit on the birch trees leading to the town square. The ceiling you've seen in the town square is nowhere to be seen, a thick white blanket covering the sky instead.

* * *

>play rock for polly
SCISSORS!
Polly: I lost?!
Polly gives you a gem.

>check gems
You currently have 10 gems.

>w
Tree-lined Path
A silent path. A few owls sit on the birch trees leading to the town square. The ceiling you've seen in the town square is nowhere to be seen, a thick white blanket covering the sky instead.

* * *

>w
Tavern
A lively place. A live band is performing is in the back, and dozens of people are gathered at tiny coffee tables, enjoying hot beverages.

You can see a black tea, chamomile tea, a slippery elm tea, Lars, Snowman, Dan, Ginny, Bugcatcher and Schoolteacher here.

>ask lars about making tea
Lars: Here you go.Obtained hot tea.

* * *

>s
You're not sure how to proceed...

>ask polly about her
I'm Polly. I'm Polly. I love rock-paper-scissors! RPS! Play!

>ščay rps with polly
That's not a verb I recognise.

>play rps with polly
stratus

>play rps with polly
cirrus

>play rps with polly
cirrus

>play rps with polly
nimbus

>play rps with polly
cirrus

* * *

>s
You're not sure how to proceed...

>play rps with polly
rock

>play rps with polly
rock

>play rps with polly
scissors

>play rps with polly
scissors

>play rps with polly
paper

>play rps with polly
paper

>play rps with polly
scissors

>play rps with old lady
They don't seem to be interested.

* * *

>s
You're not sure how to proceed...

>choose rock for polly
That's not a verb I recognise.

>play rock for polly
scissors

>play rock for polly
paper

>play rock for polly
scissors

>play rock for polly
rock

>play rock for polly
paper

* * *

>s
You're not sure how to proceed...

>play rock for polly
SCISSORS

>play rock for polly
PAPER

>play rock for polly
ROCK

>play rock for polly
PAPER

* * *

>play rock for polly
ROCK

>play rock for polly
SCISSORS

>play rock for polly
SCISSORS

>play rock for polly
ROCK

>play rock for polly
ROCK

* * *

>play rock for polly
PAPER

>play rock for polly
PAPER

* * *

>s
You're not sure how to proceed...

>check gems
You currently have 0 gems.

>play rock for polly
SCISSORSI lost?!

>check gems
You currently have 0 gems.

* * *

>s
You're not sure how to proceed...

>n
Dreams
You find yourself in another clearing of the forest, but the trees around you appear to be violet in color. There is a clear stream in the middle of the clearing through which busy colorful fish swim. Small dragonflowers swaying in the trees emit a gentle light.

You can see Weeping Blue and a horned rabbit here.

>s
Town Square
You can see Old lady, Gentleman, Curious girl, Nutcracker, Fisherman, Polly and a purse here.

>w
Calm Pond
A small pond, perfectly still. The sky is covered in white, unmoving clouds. There is a wooden platform next to the north of here. You see a young man sitting on said platform in the distance.

You can see a bucket here.

* * *

>n
Wooden Platform
A simple wooden platform for fishermen to sit at and put their belongings on.

You can see Murmur here.

>play rock for murmur
SCISSORS.
I lose.
Murmur gives you 5 gems as a prize.

>play rock for murmur
SCISSORS.
I lose.

>play rock for murmur
SCISSORS.
I lose.

>play rock for murmur
PAPER.
A win.

>play rock for murmur
ROCK.
Nothing.

>play rock for murmur
SCISSORS.
I lose.

>gem collection
That's not a verb I recognise.

>check gems
You currently have 5 gems.

* * *

>e
Town Square
You can see Old lady, Gentleman, Curious girl, Nutcracker, Fisherman, Polly and a purse here.

>play rock for polly
ROCK!
Draw!

>play rock for polly
PAPER!
You lose! You lose!

* * *

>play rock for polly
SCISSORS!
I lost?!
Polly gives you a gem.

>check gems
You currently have 6 gems.

>play rock for polly
PAPER!
You lose! You lose!

>play rock for polly
PAPER!
You lose! You lose!

* * *

>play rock for polly
SCISSORS!
I lost?!
Polly gives you a gem.

>play rock for polly
SCISSORS!
I lost?!
Polly gives you a gem.

>play rock for polly
ROCK!
Draw!

>play rock for polly
SCISSORS!
I lost?!
Polly gives you a gem.

>play rock for polly
PAPER!
You lose! You lose!

>play rock for polly
SCISSORS!
I lost?!

>check gems
You currently have 10 gems.

>play rock for gentleman
They don't seem to be interested.

* * *

>s
You're not sure how to proceed...

>pat polly
That's not a verb I recognise.

>pet polly
You pet Polly. Polly pats back, like a true parrot.

>n
Dreams
You find yourself in another clearing of the forest, but the trees around you appear to be violet in color. There is a clear stream in the middle of the clearing through which busy colorful fish swim. Small dragonflowers swaying in the trees emit a gentle light.

You can see Weeping Blue and a horned rabbit here.

>e
First path
As you move deeper into the forest, you can see a tree-lined path that splits left and right. There is a carving in the middle of a giant tree, barely noticeable.

* * *

>n
Clearing
It's dark and foggy, so you don't see much. There's dark grass bluish in color from the light emitted by the few fireflies swirling around you. Trees as far and wide as the eye can see.

You can see an old sign here.

>w
Hidden Cave
A small dark cave. You hear drops of water slowly fall to the watery ground beneath you. It's surprisingly cold for such a small space.

You can see a duck and a breadloaf here.

>pet duck
You can only do that to something animate.

>s
You can't go that way.

>e
Clearing
It's dark and foggy, so you don't see much. There's dark grass bluish in color from the light emitted by the few fireflies swirling around you. Trees as far and wide as the eye can see.

You can see an old sign here.

* * *

>w
Dreams
You find yourself in another clearing of the forest, but the trees around you appear to be violet in color. There is a clear stream in the middle of the clearing through which busy colorful fish swim. Small dragonflowers swaying in the trees emit a gentle light.

You can see Weeping Blue and a horned rabbit here.

>pet horned rabbit
You pet the horned rabbit. Its fur is very soft and fluffy. The weather was stormy. You're sure of it.

* * *

>s
You're not sure how to proceed...

>tell joke to old lady
You tell the old lady a knock knock joke, and she bawls from laughter. As reward, you're given a cookie from her basket.

>look at cookie
A chocolate-chip cookie, freshly baked and still warm. You know you're not supposed to eat it, but honestly, the notion is very tempting.

>n
Dreams
You find yourself in another clearing of the forest, but the trees around you appear to be violet in color. There is a clear stream in the middle of the clearing through which busy colorful fish swim. Small dragonflowers swaying in the trees emit a gentle light.

You can see Weeping Blue and a horned rabbit here.

* * *

>take duck
The duck eyes the cookie you're carrying hungrily. You prepare to feed the bird, but it lunges at you and steals the cookie. You got the duck, but lost the cookie in the process.

>look at cookie
You can't see any such thing.

>e
Clearing
It's dark and foggy, so you don't see much. There's dark grass bluish in color from the light emitted by the few fireflies swirling around you. Trees as far and wide as the eye can see.

You can see an old sign here.

* * *

>s
Town Square
You can see Old lady, Gentleman, Curious girl, Nutcracker, Fisherman, Polly and a purse here.

>tell joke to old lady
You tell the old lady a knock knock joke, and she bawls from laughter. As reward, you're given a cookie from her basket.

* * *

>inventory
You are carrying:
  a cookie
  a duck

>look at cookie
A chocolate-chip cookie, freshly baked and still warm. You know you're not supposed to eat it, but honestly, the notion is very tempting.

>look at duck
A sitting white duck. It's feathers are very soft to the touch - agh! It bit you!

* * *

>check hp
You currently have 30 HP.

>inventory
You are carrying nothing.

>tell joke to old lady
You tell the old lady a knock knock joke, and she bawls from laughter. As reward, you're given a cookie from her basket.

>inventory
You are carrying:
  a cookie

>n
Dreams
You find yourself in another clearing of the forest, but the trees around you appear to be violet in color. There is a clear stream in the middle of the clearing through which busy colorful fish swim. Small dragonflowers swaying in the trees emit a gentle light.

You can see Weeping Blue and a horned rabbit here.

>catch rabbit
You run after the horned rabbit and it starts fleeing. You follow the rabbit out of the clearing, landing in a new area.

Town Square
You can see Old lady, Gentleman, Curious girl, Nutcracker, Fisherman, Polly and a purse here.

You caught the rabbit, but it scracthes you in the process. Lost 5 HP.

>check hp
You currently have 25 HP.

>inventory
You are carrying:
  a cookie

* * *

>s
You're not sure how to proceed...

>ask lotty about the dragon
There is no reply.

>ask lotty about dragon
Lotty: The dragon sleeps at the bottom of the clock tower and needs only a swing of its wings to climb the tower. But in the off chance that it attacks you...
Lotty: Maybe this will help!
Lotty produces an omelette out of her basket and shoves it into your hands clumsily.

>inventory
You are carrying:
  an omelette

>eat omelette
You ate the omelette. HP up!

>inventory
You are carrying nothing.

>check hp
You currently have 30 HP.

>ask lotty about the dragon
There is no reply.

>ask lotty about dragon
Lotty: The dragon sleeps at the bottom of the clock tower and needs only a swing of its wings to climb the tower. But in the off chance that it attacks you...
Lotty: Cooking is something I really enjoy. But I only had one with me today. Sorry!

>inventory
You are carrying nothing.

* * *

>s
You're not sure how to proceed...

>ask old lady about joke
Why couldn't the pony sing in the choir? He was a little horse.

>ask old lady about joke
Knock knock! Who's there? Old lady. Old lady Who? Why, I didn't think you could yodel!

>ask old lady about joke
Last time I tried stealing a calendar, I got 3 months.

>ask old lady about joke
Want to hear something terrible? Paper. See? I told you it was tear-able.

>ask old lady about joke
I can't believe I haven't gone to the gym today. It's been seven years in a row!

>ask old lady about joke
How do trees get online? They just log in.

>ask old lady about joke
Last time I tried stealing a calendar, I got 3 months.

>ask old lady about joke
Last time I tried stealing a calendar, I got 3 months.

>ask old lady about joke
I can't believe I haven't gone to the gym today. It's been seven years in a row!

>ask old lady about joke
Why couldn't the pony sing in the choir? He was a little horse.

>ask old lady about joke
Why was the queen's army too tired to fight? Well, it had too many sleepless knights!

>ask old lady about joke
How can you tell when a clock is hungry? It goes back four seconds.

>ask old lady about joke
I can't believe I haven't gone to the gym today. It's been seven years in a row!

* * *

>s
You're not sure how to proceed...

>look at gentleman
A tall gentleman, fair-skinned and dark-haired, standing in front of the clock tower. His eyes are fixed on anything and everything but on you. He also wears a ridiculously large tophat that you can't seem to stop staring at.

>w
Tree-lined Path
A silent path. A few owls sit on the birch trees leading to the town square. The ceiling you've seen in the town square is nowhere to be seen, a thick white blanket covering the sky instead.

* * *

>s
Calm Pond
A small pond, perfectly still. The sky is covered in white, unmoving clouds. There is a wooden platform next to the north of here. You see a young man sitting on said platform in the distance.

You can see a bucket here.

>w
You can't go that way.

* * *

>s
You're not sure how to proceed...

>s
You're not sure how to proceed...

>catch horned rabbit
You run after the horned rabbit and it starts fleeing. You follow the rabbit out of the clearing, landing in a new area.

Town Square
A large clearing in the forest populated by dozens of wooden houses giving off a cozy feeling. There's solid ground underneath your feet, and a large ceiling above your head. You can't make out the material it's made out of. There's large streetlamps to illuminate the path and a large fountain of clear water in the middle. Children are dnacing in a circle in the bag, a cat is meowing from a roof. People walk around, chat, look at you as you stand at the entrance. An imposing clock tower can be seen from the distance, almost reaching the white round drawing of a moon. The smell of wood and bakeries is overwhelming.

You can see Old lady, Gentleman, Lotty, Nutcracker, Fisherman, Polly and a purse here.

>n
Dreams
You find yourself in another clearing of the forest, but the trees around you appear to be violet in color. There is a clear stream in the middle of the clearing through which busy colorful fish swim. Small dragonflowers swaying in the trees emit a gentle light.

You can see Weeping Blue and a horned rabbit here.

>s
Town Square
A large clearing in the forest populated by dozens of wooden houses giving off a cozy feeling. There's solid ground underneath your feet, and a large ceiling above your head. You can't make out the material it's made out of. There's large streetlamps to illuminate the path and a large fountain of clear water in the middle. Children are dnacing in a circle in the bag, a cat is meowing from a roof. People walk around, chat, look at you as you stand at the entrance. An imposing clock tower can be seen from the distance, almost reaching the white round drawing of a moon. The smell of wood and bakeries is overwhelming.

You can see Old lady, Gentleman, Lotty, Nutcracker, Fisherman, Polly and a purse here.

>s
You can't go that way.

>w
Tree-lined Path
A silent path. A few owls sit on the birch trees leading to the town square. The ceiling you've seen in the town square is nowhere to be seen, a thick white blanket covering the sky instead.

* * *

>s
You're not sure how to proceed...

>catch rabbit
You run after the horned rabbit and it starts fleeing. You follow the rabbit out of the clearing, landing in a new area.

Town Square
A large clearing in the forest populated by dozens of wooden houses giving off a cozy feeling. There's solid ground underneath your feet, and a large ceiling above your head. You can't make out the material it's made out of. There's large streetlamps to illuminate the path and a large fountain of clear water in the middle. Children are dnacing in a circle in the bag, a cat is meowing from a roof. People walk around, chat, look at you as you stand at the entrance. An imposing clock tower can be seen from the distance, almost reaching the white round drawing of a moon. The smell of wood and bakeries is overwhelming.

You can see Old lady, Gentleman, Lotty, Nutcracker, Fisherman, Polly and a purse here.

>e
Clock Tower
An ancient clock tower, made with brown stone and covered in ivies that climbed its walls for ages. Its tower reaches well into the man-made ceiling, the tip of it nearly touching the yellow drawing of the inexistant moon of this world. The hands of time seem to flow seamlessly into the wrong side. As you enter the building, you're met with an owl guard whose head turns into your diretion as your first footsteps echo through the marble-covered floor. To the north, you see a staircase that leads up the slim tower, seemingly leading into a circle as you climb the building. To the east, there is a dark entrance, something shining gleaming from behind it.

You can see Owl here.

* * *

>temporal hoot
The owl's eyes widen and it hoots. The clock behind it shows time ticking in the right direction again.

>w
Town Square
A large clearing in the forest populated by dozens of wooden houses giving off a cozy feeling. There's solid ground underneath your feet, and a large ceiling above your head. You can't make out the material it's made out of. There's large streetlamps to illuminate the path and a large fountain of clear water in the middle. Children are dnacing in a circle in the bag, a cat is meowing from a roof. People walk around, chat, look at you as you stand at the entrance. An imposing clock tower can be seen from the distance, almost reaching the white round drawing of a moon. The smell of wood and bakeries is overwhelming.

You can see Old lady, Gentleman, Lotty, Nutcracker, Fisherman, Polly and a purse here.

>e
Clock Tower
An ancient clock tower, made with brown stone and covered in ivies that climbed its walls for ages. Its tower reaches well into the man-made ceiling, the tip of it nearly touching the yellow drawing of the inexistant moon of this world. The hands of time seem to flow seamlessly into the wrong side. As you enter the building, you're met with an owl guard whose head turns into your diretion as your first footsteps echo through the marble-covered floor. To the north, you see a staircase that leads up the slim tower, seemingly leading into a circle as you climb the building. To the east, there is a dark entrance, something shining gleaming from behind it.

You can see Owl here.

* * *

>ring bell
The dragon suddely attacked! You have to defeat it before you can ring the bell! You can either attack, defend, or use consumables!

>ring bell
The dragon suddely attacked! You have to defeat it before you can ring the bell! You can either attack, defend, or use consumables!

>attack dragon
You swing at the dragon with all your might! The dragon takes 5 damage!

DRAGON'S TURN

>check hp
You currently have 30 HP.

>attack dragon
You swing at the dragon with all your might! The dragon takes 5 damage!

DRAGON'S TURN

>attack dragon
You swing at the dragon with all your might! The dragon takes 5 damage!

DRAGON'S TURN
The dragon swings its claws at you! You lost 7 HP!

>check hp
You currently have 23 HP.

* * *

>n
The owl lets you through.

Bell Tower
The climb up the stairs is arduous and dizzying. Something doesn't feel quite right as you ascend the endless tower. But then you exit, and a gust of harsh wind blows into your face. You find yourself at the top of the tower, right below the glowing painted moon. In front of you, there is a giant bell, filled with ancient reliefs and jewels, just ready to be rung. A fierce dragon stands in front of it protectively, asserting your intentions.

>s
Clock Tower
An ancient clock tower, made with brown stone and covered in ivies that climbed its walls for ages. Its tower reaches well into the man-made ceiling, the tip of it nearly touching the yellow drawing of the inexistant moon of this world. The hands of time seem to flow seamlessly into the wrong side. As you enter the building, you're met with an owl guard whose head turns into your diretion as your first footsteps echo through the marble-covered floor. To the north, you see a staircase that leads up the slim tower, seemingly leading into a circle as you climb the building. To the east, there is a dark entrance, something shining gleaming from behind it.

You can see Owl here.

>n
The owl lets you through.

Bell Tower
The climb up the stairs is arduous and dizzying. Something doesn't feel quite right as you ascend the endless tower. But then you exit, and a gust of harsh wind blows into your face. You find yourself at the top of the tower, right below the glowing painted moon. In front of you, there is a giant bell, filled with ancient reliefs and jewels, just ready to be rung. A fierce dragon stands in front of it protectively, asserting your intentions.

* * *

>ring bell
The dragon suddely attacked! You have to defeat it before you can ring the bell! You can either attack, defend, or use consumables!

>s
You can't run from the dragon!

>s
You can't run from the dragon!

>attack dragon
You swing at the dragon with all your might! The dragon takes 5 damage!

DRAGON'S TURN
The dragon heals its wounds. It regained 5 HP!

* * *

>attack dragon
You swing at the dragon with all your might! The dragon takes 5 damage!

DRAGON'S TURN
The dragon has to recharge and does nothing this turn.

>attack dragon
You swing at the dragon with all your might! The dragon takes 5 damage!

DRAGON'S TURN
The dragon swings its claws at you! You lost 7 HP!
The dragon swings its claws at you! You lost 10 HP!

>attack dragon
You swing at the dragon with all your might! The dragon takes 5 damage!

DRAGON'S TURN
The dragon blows fire! You lost 15 HP!

    *** You've lost all your HP! You're unable to continue your journey. ***

Would you like to RESTART, RESTORE a saved game, QUIT or UNDO the last command?

* * *

>w
Dreams
You find yourself in another clearing of the forest, but the trees around you appear to be violet in color. There is a clear stream in the middle of the clearing through which busy colorful fish swim. Small dragonflowers swaying in the trees emit a gentle light.

You can see Weeping Blue and a horned rabbit here.

>catch horned rabbit
You run after the horned rabbit and it starts fleeing. You follow the rabbit out of the clearing, landing in a new area.

Town Square
A large clearing in the forest populated by dozens of wooden houses giving off a cozy feeling. There's solid ground underneath your feet, and a large ceiling above your head. You can't make out the material it's made out of. There's large streetlamps to illuminate the path and a large fountain of clear water in the middle. Children are dnacing in a circle in the bag, a cat is meowing from a roof. People walk around, chat, look at you as you stand at the entrance. An imposing clock tower can be seen from the distance, almost reaching the white round drawing of a moon. The smell of wood and bakeries is overwhelming.

You can see Old lady, Gentleman, Lotty, Nutcracker, Fisherman, Polly and a purse here.

>e
Clock Tower
An ancient clock tower, made with brown stone and covered in ivies that climbed its walls for ages. Its tower reaches well into the man-made ceiling, the tip of it nearly touching the yellow drawing of the inexistant moon of this world. The hands of time seem to flow seamlessly into the wrong side. As you enter the building, you're met with an owl guard whose head turns into your diretion as your first footsteps echo through the marble-covered floor. To the north, you see a staircase that leads up the slim tower, seemingly leading into a circle as you climb the building. To the east, there is a dark entrance, something shining gleaming from behind it.

You can see Owl here.

>e
The owl forbids you from entering the chamber. It grabs you and flies out with you!

Town Square
A large clearing in the forest populated by dozens of wooden houses giving off a cozy feeling. There's solid ground underneath your feet, and a large ceiling above your head. You can't make out the material it's made out of. There's large streetlamps to illuminate the path and a large fountain of clear water in the middle. Children are dnacing in a circle in the bag, a cat is meowing from a roof. People walk around, chat, look at you as you stand at the entrance. An imposing clock tower can be seen from the distance, almost reaching the white round drawing of a moon. The smell of wood and bakeries is overwhelming.

You can see Old lady, Gentleman, Lotty, Nutcracker, Fisherman, Polly and a purse here.

>e
Clock Tower
An ancient clock tower, made with brown stone and covered in ivies that climbed its walls for ages. Its tower reaches well into the man-made ceiling, the tip of it nearly touching the yellow drawing of the inexistant moon of this world. The hands of time seem to flow seamlessly into the wrong side. As you enter the building, you're met with an owl guard whose head turns into your diretion as your first footsteps echo through the marble-covered floor. To the north, you see a staircase that leads up the slim tower, seemingly leading into a circle as you climb the building. To the east, there is a dark entrance, something shining gleaming from behind it.

You can see Owl here.

* * *

I beg your pardon?

* * *

>look
Clock Tower
An ancient clock tower, made with brown stone and covered in ivies that climbed its walls for ages. Its tower reaches well into the man-made ceiling, the tip of it nearly touching the yellow drawing of the inexistant moon of this world. The hands of time seem to flow seamlessly into the wrong side. As you enter the building, you're met with an owl guard whose head turns into your diretion as your first footsteps echo through the marble-covered floor. To the north, you see a staircase that leads up the slim tower, seemingly leading into a circle as you climb the building. To the east, there is a dark entrance, something shining gleaming from behind it.

You can see Owl here.

* * *

>ring bell
The dragon suddely attacked! You have to defeat it before you can ring the bell! You can either attack, defend from dragon, or use consumables!

>attack
(the dragon)
You swing at the dragon with all your might! The dragon takes 10 damage!

DRAGON'S TURN
The dragon has to recharge and does nothing this turn.

>attack
(the dragon)
You swing at the dragon with all your might! The dragon takes 10 damage!

DRAGON'S TURN
The dragon heals its wounds. It regained 5 HP!

>attack
(the dragon)
You swing at the dragon with all your might! The dragon takes 10 damage!

DRAGON'S TURN
The dragon heals its wounds. It regained 5 HP!

>attack dragon
You swing at the dragon with all your might! The dragon takes 10 damage!

DRAGON'S TURN
The dragon heals its wounds. It regained 5 HP!

* * *

>attack dragon
You swing at the dragon with all your might! The dragon takes 10 damage!

DRAGON'S TURN
The dragon blows fire! You lost 15 HP!

>check hp
You currently have 8 HP.

* * *

>e
Diverging path
As you move deeper into the forest, you can see a tree-lined path that splits left and right. There is a carving in the middle of a giant tree, barely noticeable.

>w
Dreams
You find yourself in another clearing of the forest, but the trees around you appear to be violet in color. There is a clear stream in the middle of the clearing through which busy colorful fish swim. Small dragonflowers swaying in the trees emit a gentle light.

You can see Weeping Blue and a horned rabbit here.

* * *

>ring bell
The dragon suddely attacked! You have to defeat it before you can ring the bell! You can either attack, defend from dragon, or use consumables!

>attack dragon
You swing at the dragon with all your might! The dragon takes 10 damage!

DRAGON'S TURN
The dragon swings its claws at you! You lost 10 HP!

>attack dragon
You swing at the dragon with all your might! The dragon takes 10 damage!

DRAGON'S TURN
The dragon swings its claws at you! You lost 10 HP!

>check hp
You currently have 10 HP.

>attack
(the dragon)
You swing at the dragon with all your might! The dragon takes 10 damage!

DRAGON'S TURN
The dragon swings its claws at you! You lost 10 HP!

    *** You've lost all your HP! You're unable to continue your journey. ***

Would you like to RESTART, RESTORE a saved game, QUIT or UNDO the last command?

>q
Please give one of the answers above.

Would you like to RESTART, RESTORE a saved game, QUIT or UNDO the last command?

* * *

>e
Diverging path
As you move deeper into the forest, you can see a tree-lined path that splits left and right. There is a carving in the middle of a giant tree, barely noticeable.

>n
Clearing
It's dark and foggy, so you don't see much. There's dark grass bluish in color from the light emitted by the few fireflies swirling around you. Trees as far and wide as the eye can see. There's an old sign here.

>take mirror
You can't see any such thing.

>n
Treestump
A large treestump is lying vertically on the ground of the clearing. A few toadstools sit around it, acting as lamps.

You can see a flashlight, a mirror and a fishhook here.

* * *

>tell joke to old lady
You tell the old lady a knock knock joke, and she bawls from laughter. As reward, you're given a cookie from her basket.

* * *

>n
Clearing
It's dark and foggy, so you don't see much. There's dark grass bluish in color from the light emitted by the few fireflies swirling around you. Trees as far and wide as the eye can see. There's an old sign here.

>e
Hidden Cave
A small dark cave. You hear drops of water slowly fall to the watery ground beneath you. It's surprisingly cold for such a small space.

You can see a duck here.

* * *

>take duck
The duck eyes the cookie you're carrying hungrily. You prepare to feed the bird, but it lunges at you and steals the cookie. You got the duck, but lost the cookie in the process.

>w
Clearing
It's dark and foggy, so you don't see much. There's dark grass bluish in color from the light emitted by the few fireflies swirling around you. Trees as far and wide as the eye can see. There's an old sign here.

>s
Diverging path
As you move deeper into the forest, you can see a tree-lined path that splits left and right. There is a carving in the middle of a giant tree, barely noticeable.

* * *

>give duck to lotty
Lotty: Thank you so much! I've missed you so much...
Lotty hugs the duck close to her chest.
Lotty: Give this to my brother. I'm sure he will warm up to you.
You got a golden egg.

>ask lotty about dragon
Lotty: The dragon sleeps at the bottom of the clock tower and needs only a swing of its wings to climb the tower.
Lotty: But in the off chance that it attacks you... Maybe this will help!
Lotty produces an omelette out of her basket and shoves it into your hands clumsily.

>w
Tree-lined Path
A silent path. A few owls sit on the birch trees leading to the town square. The ceiling you've seen in the town square is nowhere to be seen, a thick white blanket covering the sky instead.

* * *

>n
Wooden Platform
A simple wooden platform for fishermen to sit at and put their belongings on.

You can see Murmur here.

>ask murmur about how his father came here
The man gave no response.

>give bucket to murmur
The young man extends his hand to take the item. He nods curtly, then fastens one of the worms to the hook. You'll never like the sight of it.

>ask murmur about how his father came here
He went... fishing one day. Then disappeared. It was just me and my father, back then. When he didn't come back, I...
He winces.
I found his straw hat the same day, near the lake where he would fish every day. But there was no sign of him. For a year. He always wished for a change... I gave up evetually. Just continued fishing by the lake.
Your head starts to hurt. You want to remember... You feel a surge of power! Increased attack by 2.

>e
You can't go that way.

>s
Calm Pond
A small pond, perfectly still. The sky is covered in white, unmoving clouds. There is a wooden platform next to the north of here. You see a young man sitting on said platform in the distance.

* * *

>e
Tree-lined Path
A silent path. A few owls sit on the birch trees leading to the town square. The ceiling you've seen in the town square is nowhere to be seen, a thick white blanket covering the sky instead.

>w
Calm Pond
A small pond, perfectly still. The sky is covered in white, unmoving clouds. There is a wooden platform next to the north of here. You see a young man sitting on said platform in the distance.

* * *

>take chamomile tea
Taken.

>give chamomile tea to ginny
Ginny: No, thank you. I still have so much to learn and... I must prove myself.
Ginny's words echo through you. Something about them feels so familiar... You want to remember. You feel a surge of power! Defense rose by 3!

>give golden egg to lars
Lars: So you've helped my sister, ey. In that case, you can go to the cellar north of here. There might be something in it for you.

>n
Cellar RM0
A completely dark room with not an ounce of light if not for the lightbulb at the entrance. Your cellar starting point. There's a strong smell of moisture in the air, and you hear trickling of water from above. You can't see much.

* * *

>e
Cellar RM1
A completely dark room, same as the rest. There's a strong smell of moisture in the air, and you hear trickling of water from above. You can't see much.

>n
Cellar RM4
A completely dark room, same as the rest. There's a strong smell of moisture in the air, and you hear trickling of water from above. You can't see much.

>e
Cellar RM6
A completely dark room, same as the rest. There's a strong smell of moisture in the air, and you hear trickling of water from above. You can't see much.

>n
Cellar RM7
A room lit by a single light bulb hanging from the ceiling. There's a strong smell of moisture in the air, and you hear trickling of water from above. This room smells of tea and condiments.

You can see a metal box (in which is a teleportation charm) here.

>s
Cellar RM6
A completely dark room, same as the rest. There's a strong smell of moisture in the air, and you hear trickling of water from above. You can't see much.

>w
Cellar RM4
A completely dark room, same as the rest. There's a strong smell of moisture in the air, and you hear trickling of water from above. You can't see much.

>n
Cellar RM5
A small room with a lightbulb attached to the ceiling, making the room somewhat visible. This room leads to no new rooms; you can exit to the south.

You can see a cardboard box (in which is a revive) here.

* * *

>take revive
Taken.

>s
Cellar RM4
A completely dark room, same as the rest. There's a strong smell of moisture in the air, and you hear trickling of water from above. You can't see much.

>s
Cellar RM1
A completely dark room, same as the rest. There's a strong smell of moisture in the air, and you hear trickling of water from above. You can't see much.

>w
Cellar RM0
A completely dark room with not an ounce of light if not for the lightbulb at the entrance. Your cellar starting point. There's a strong smell of moisture in the air, and you hear trickling of water from above. You can't see much.

>s
Tavern
A lively place. A live band is performing is in the back, and dozens of people are gathered at tiny coffee tables, enjoying hot beverages.

You can see a black tea, a slippery elm tea, Lars, Snowman, Dan, Ginny, Bugcatcher and Schoolteacher here.

>e
Yard
A small yard leading to a cozy wooden tavern just west of here.

You can see Large Bear here.

* * *

>e
Calm Pond
A small pond, perfectly still. The sky is covered in white, unmoving clouds. There is a wooden platform next to the north of here. You see a young man sitting on said platform in the distance.

>check attack
Your attack stat is 2.

>check defense
Your defense stat is 3.

>w
Yard
A small yard leading to a cozy wooden tavern just west of here.

You can see Large Bear here.

* * *

>w
Tavern
A lively place. A live band is performing is in the back, and dozens of people are gathered at tiny coffee tables, enjoying hot beverages.

You can see a black tea, a slippery elm tea, Lars, Snowman, Dan, Ginny, Bugcatcher and Schoolteacher here.

>ask alrs about making tea
You can't see any such thing.

>ask lars about making tea
Lars: Here you go.
Obtained hot tea.

* * *

>give purse to large bear
The bear seems ecstatic! It lurches forward, grabs the purse from your hands and swings it over its shoulder. She bats her eyelashes at you. She politely reaches into her purse to - somehow - pull out a diamond sword.
Equipping the diamond sword, your attack rose!

>check attack
Your attack stat is 12.

>r
That's not a verb I recognise.

* * *

>w
Tavern
A lively place. A live band is performing is in the back, and dozens of people are gathered at tiny coffee tables, enjoying hot beverages.

You can see a black tea, a slippery elm tea, Lars, Snowman, Dan, Ginny, Bugcatcher and Schoolteacher here.

>e
Yard
A small yard leading to a cozy wooden tavern just west of here.

You can see Large Bear here.

* * *

>e
Calm Pond
A small pond, perfectly still. The sky is covered in white, unmoving clouds. There is a wooden platform next to the north of here. You see a young man sitting on said platform in the distance.

I beg your pardon?

>e
Tree-lined Path
A silent path. A few owls sit on the birch trees leading to the town square. The ceiling you've seen in the town square is nowhere to be seen, a thick white blanket covering the sky instead.

* * *

>ring bell
The dragon suddely attacked! You have to defeat it before you can ring the bell! You can either attack, defend from dragon, or use consumables!

>attack dragon
You swing at the dragon with all your might! The dragon takes 17 damage!

DRAGON'S TURN
The dragon blows fire! You lost 12 HP!

>check hp
You currently have 18 HP.

>attack dragon
You swing at the dragon with all your might! The dragon takes 17 damage!

DRAGON'S TURN
The dragon heals its wounds. It regained 5 HP!

>check hp
You currently have 18 HP.

>attack dragon
You swing at the dragon with all your might! The dragon takes 17 damage!

DRAGON'S TURN
The dragon swings its claws at you! You lost 7 HP!

>check hp
You currently have 11 HP.

>attack dragon
You swing at the dragon with all your might! The dragon takes 17 damage!

DRAGON'S TURN
The dragon heals its wounds. It regained 5 HP!

>attack dragon
You swing at the dragon with all your might! The dragon takes 17 damage!

DRAGON'S TURN
The dragon heals its wounds. It regained 5 HP!

>attack dragon
You swing at the dragon with all your might! The dragon takes 17 damage!

DRAGON'S TURN
The dragon swings its claws at you! You lost 7 HP!

>check hp
You currently have 4 HP.

>defend from dragon
You defend from the dragon's next attack. You gain temporary 5 defense!

DRAGON'S TURN
The dragon has to recharge and does nothing this turn.

>defend from dragon
You defend from the dragon's next attack. You gain temporary 5 defense!

DRAGON'S TURN
The dragon blows fire! You lost 7 HP!
The revive has revived you!

>check hp
You currently have 30 HP.

>attack dragon
You swing at the dragon with all your might! The dragon takes 17 damage!
The dragon is defeated! It bows to you and clears the way to the bell.

>ring bell
The dragon bows its head.
You rang the bell. It's soothing sound echoes through the area... Oh? But what's this? Something seems to have fallen out of it as you rung it.
You obtained the shiny key!

>look
Bell Tower
The climb up the stairs is arduous and dizzying. Something doesn't feel quite right as you ascend the endless tower. But then you exit, and a gust of harsh wind blows into your face. You find yourself at the top of the tower, right below the glowing painted moon. In front of you, there is a giant bell, filled with ancient reliefs and jewels, just ready to be rung. A fierce dragon stands in front of it protectively, asserting your intentions.

>s
Clock Tower
An ancient clock tower, made with brown stone and covered in ivies that climbed its walls for ages. Its tower reaches well into the man-made ceiling, the tip of it nearly touching the yellow drawing of the inexistant moon of this world. The hands of time seem to flow seamlessly into the wrong side. As you enter the building, you're met with an owl guard whose head turns into your diretion as your first footsteps echo through the marble-covered floor. To the north, you see a staircase that leads up the slim tower, seemingly leading into a circle as you climb the building. To the east, there is a dark entrance, something shining gleaming from behind it.

You can see Owl here.

>teleport
You haven't mastered the arts of teleportation yet. Haven't even started, in fact.

>s
You can't go that way.

>e
The owl's feathers ruffle, but it remains still.

Treasury
A large open room filled with the brim with gold coins and gems. A large dragon sleeps on top of it all, snoring contently. There's a worn sign here.

>w
Clock Tower
An ancient clock tower, made with brown stone and covered in ivies that climbed its walls for ages. Its tower reaches well into the man-made ceiling, the tip of it nearly touching the yellow drawing of the inexistant moon of this world. The hands of time seem to flow seamlessly into the wrong side. As you enter the building, you're met with an owl guard whose head turns into your diretion as your first footsteps echo through the marble-covered floor. To the north, you see a staircase that leads up the slim tower, seemingly leading into a circle as you climb the building. To the east, there is a dark entrance, something shining gleaming from behind it.

You can see Owl here.

>s
You can't go that way.

>w
Town Square
A large clearing in the forest populated by dozens of wooden houses giving off a cozy feeling. There's solid ground underneath your feet, and a large ceiling above your head. You can't make out the material it's made out of. There's large streetlamps to illuminate the path and a large fountain of clear water in the middle. Children are dnacing in a circle in the bag, a cat is meowing from a roof. People walk around, chat, look at you as you stand at the entrance. An imposing clock tower can be seen from the distance, almost reaching the white round drawing of a moon. The smell of wood and bakeries is overwhelming.

You can see Old lady, Gentleman, Lotty, Nutcracker, Fisherman and Polly here.

* * *

>n
Dreams
You find yourself in another clearing of the forest, but the trees around you appear to be violet in color. There is a clear stream in the middle of the clearing through which busy colorful fish swim. Small dragonflowers swaying in the trees emit a gentle light.

You can see Weeping Blue and a horned rabbit here.

>s
Town Square
A large clearing in the forest populated by dozens of wooden houses giving off a cozy feeling. There's solid ground underneath your feet, and a large ceiling above your head. You can't make out the material it's made out of. There's large streetlamps to illuminate the path and a large fountain of clear water in the middle. Children are dnacing in a circle in the bag, a cat is meowing from a roof. People walk around, chat, look at you as you stand at the entrance. An imposing clock tower can be seen from the distance, almost reaching the white round drawing of a moon. The smell of wood and bakeries is overwhelming.

You can see Old lady, Gentleman, Lotty, Nutcracker, Fisherman and Polly here.

>remember
You're still getting dizzy as you try to remember. There was a storm. And something golden in it. You're sure of it.

>n
Dreams
You find yourself in another clearing of the forest, but the trees around you appear to be violet in color. There is a clear stream in the middle of the clearing through which busy colorful fish swim. Small dragonflowers swaying in the trees emit a gentle light.

You can see Weeping Blue and a horned rabbit here.

* * *

>reach for gold
You reach for the golden object shimmering in the stream, but your head suddenly starts to hurt horribly, stopping you in your action.
You want to remember... You feel a surge of energy! Defense increased by 2!

>remember
You're still getting dizzy as you try to remember, but it's more vivid now. A stormy sea, a golden gleam, and a fervent desire to prove yourself.

>s
Town Square
A large clearing in the forest populated by dozens of wooden houses giving off a cozy feeling. There's solid ground underneath your feet, and a large ceiling above your head. You can't make out the material it's made out of. There's large streetlamps to illuminate the path and a large fountain of clear water in the middle. Children are dnacing in a circle in the bag, a cat is meowing from a roof. People walk around, chat, look at you as you stand at the entrance. An imposing clock tower can be seen from the distance, almost reaching the white round drawing of a moon. The smell of wood and bakeries is overwhelming.

You can see Old lady, Gentleman, Lotty, Nutcracker, Fisherman and Polly here.

* * *

>w
Yard
A small yard leading to a cozy wooden tavern just west of here.

You can see Large Bear here.

>e
Calm Pond
A small pond, perfectly still. The sky is covered in white, unmoving clouds. There is a wooden platform next to the north of here. You see a young man sitting on said platform in the distance.

>n
Wooden Platform
A simple wooden platform for fishermen to sit at and put their belongings on.

You can see Murmur here.

* * *

>ask murmur about how he came here
There is no reply.

>ask murmur about how he came
There is no reply.

>ask murmur about what he is doing
Fishing.

>ask murmur about how his father came to the world of wishes
There is no reply.

>ask murmur about how his father came to  world of wishes
He went... fishing one day. Then disappeared. It was just me and my father, back then. When he didn't come back, I...
He winces.
I found his straw hat the same day, near the lake where he would fish every day. But there was no sign of him. For a year. He always wished for a change... I gave up evetually. Just continued fishing by the lake.

>remember
You're still getting dizzy as you try to remember, but it's more vivid now. A stormy sea, a golden gleam, and a fervent desire to prove yourself.

>check attack
Your attack stat is 12.

>ask murmur about how he came to this world
You're  hooked  on remembering how you got here, aren't you?

>ask murmur about his father
Yes, my father is a fisherman. He's been so since forever.

>ask murmur about him
There's not much to me. I haven't heard of you, too.

* * *

>w
Town Square
A large clearing in the forest populated by dozens of wooden houses giving off a cozy feeling. There's solid ground underneath your feet, and a large ceiling above your head. You can't make out the material it's made out of. There's large streetlamps to illuminate the path and a large fountain of clear water in the middle. Children are dnacing in a circle in the bag, a cat is meowing from a roof. People walk around, chat, look at you as you stand at the entrance. An imposing clock tower can be seen from the distance, almost reaching the white round drawing of a moon. The smell of wood and bakeries is overwhelming.

You can see Old lady, Gentleman, Lotty, Nutcracker, Fisherman and Polly here.

* * *

>e
End of All
Your footsteps echo through the small wooden path as if the floor was made of marble instead of leaves. The world around you is starting to feel more and more like a dream, but your tired legs seem to suggest otherwise. There are knights in old black armor standing in front of a giant golden door. The imposing nature of the sight makes you realize this could be the end of the journey.

You can see a golden door, Left Knight and Right Knight here.

>unlock golden door
What do you want to unlock the golden door with?

>whiny key
You can't see any such thing.

>unlock golden door
What do you want to unlock the golden door with?

* * *

>shiny key
You unlock the golden door.

>go e
(first opening the golden door)

Fishtank
As you enter the last room, the thing that catches your eyes first is the giant goldfish with a red spot on its forehead, slowly floating in a waterless room as it directs its large eyes towards you. The fish - queen - stares at you for a long time, as if waiting for you to do something.

You can see a golden door here.

>look at golden door
The door in front of you is imposing and heavy. Even if you try to push with all your might, you don't think you'll succeed in opening it.

* * *

>n
Clearing
It's dark and foggy, so you don't see much. There's dark grass bluish in color from the light emitted by the few fireflies swirling around you. Trees as far and wide as the eye can see. There's an old sign here.

>n
Treestump
A large treestump is lying vertically on the ground of the clearing. A few toadstools sit around it, acting as lamps.

You can see a flashlight, a mirror and a fishhook here.

* * *

>s
Diverging path
As you move deeper into the forest, you can see a tree-lined path that splits left and right. There is a carving in the middle of a giant tree, barely noticeable.

>show mirror to weeping blue
You can't see any such thing.

>w
Dreams
You find yourself in another clearing of the forest, but the trees around you appear to be violet in color. There is a clear stream in the middle of the clearing through which busy colorful fish swim. Small dragonflowers swaying in the trees emit a gentle light.

You can see Weeping Blue and a horned rabbit here.

* * *

>show mirror to weeping blue
Weeping Blue takes the cracked mirror from your hands and looks at herself. She suddenly smiles a brilliant smile.
Thank you very much, boy. I finally remember how I look like.
In the back, the horned rabbit's eyes shine.

>reach for gold
You reach for the golden object shimmering in the stream, but your head suddenly starts to hurt horribly, stopping you in your action.
You want to remember... You feel a surge of energy! Defense increased by 2!

>approach rabbit
The rabbit seems pleased with you that you've taken the time to help the woman out of her troubles. He wants you to follow him south, while shaking 50 gems out of its furr. You obtain the gems, and follow him wordlessly.

Town Square
A large clearing in the forest populated by dozens of wooden houses giving off a cozy feeling. There's solid ground underneath your feet, and a large ceiling above your head. You can't make out the material it's made out of. There's large streetlamps to illuminate the path and a large fountain of clear water in the middle. Children are dnacing in a circle in the bag, a cat is meowing from a roof. People walk around, chat, look at you as you stand at the entrance. An imposing clock tower can be seen from the distance, almost reaching the white round drawing of a moon. The smell of wood and bakeries is overwhelming.

You can see Old lady, Gentleman, Lotty, Nutcracker, Fisherman, Polly and a purse here.

>reach for gold
You suddenly remember - you're scared of fish! You won't be reaching into that stream any time soon!

>help fisherman tie hook
You tie the fisherman's hook to the pole with a smile. The fisherman gives you 20 gems as compensation, which you politely decline. But the fisherman stuffs them into your hand nevertheless.

* * *

>w
Calm Pond
A small pond, perfectly still. The sky is covered in white, unmoving clouds. There is a wooden platform next to the north of here. You see a young man sitting on said platform in the distance.

You can see a bucket here.

>take bucker
You can't see any such thing.

>take bucket
Taken.

* * *

>give bucket to murmur
The young man extends his hand to take the item. He nods curtly, then fastens one of the worms to the hook. You'll never like the sight of it.

>look at murmur
A young man looking listlessly into the pond. Nothing can stirr him from his thoughts. He greets you with a simple wave.

>ask murmur about him
Murmur: There's not much to me. My father mentioned you. You're Stef, right?

>ask murmur about cellar
Murmur: I think there's two items in there, but don't take my word for it.

>ask murmur about his father
Murmur: Yes, my father is a fisherman. He's been so since forever.
 He means a lot to me.

>ask murmur about his fisherman
There is no reply.

>ask murmur about fisherman
Murmur: I am one.

>ask murmur about what he is doing
Murmur: Fishing.

>ask murmur about dragon
Murmur: Dragon's love treasure.

>ask murmur about how his father came here
Murmur: He went... fishing one day. Then disappeared. It was just me and my father, back then. When he didn't come back, I...
He winces.
Murmur: I found his straw hat the same day, near the lake where he would fish every day. But there was no sign of him. For a year. He always wished for a change... I gave up evetually. Just continued fishing by the lake.
Your head starts to hurt. You want to remember... You feel a surge of power! Increased attack by 2.

>ask murmur about how he came to this world
The man - very suddenly, might you add - bursts into loud laughter. He looks to you.
Murmur: I can't tell you everything, can I?

>ask murmur about fish
I release all the fish I catch. The pond would be empty by now, otherwise.

>ask murmur about gold in stream
Probably just scales. Sorry.

>s
Calm Pond
A small pond, perfectly still. The sky is covered in white, unmoving clouds. There is a wooden platform next to the north of here. You see a young man sitting on said platform in the distance.

>w
Yard
A small yard leading to a cozy wooden tavern just west of here.

You can see Large Bear here.

* * *

>take chamomile tea
Taken.

>remember
You're still getting dizzy as you try to remember. There was a storm. And something golden in it. You're sure of it.

>give chamomile to ginny
Ginny: No, thank you. I still have so much to learn and... I must prove myself.
Ginny's words echo through you. Something about them feels so familiar... You want to remember. You feel a surge of power! Defense rose by 3!

>remember
You're still getting dizzy as you try to remember, but it's more vivid now. A stormy sea, a golden gleam, and a fervent desire to prove yourself.

>ask lars about making tea
Lars: Here you go.
Obtained hot tea.

* * *

>give hot tea to gentleman
The gentleman wordlessly takes the cup of tea and goes to sit at the fountain to drink.

>inventory
You are carrying:
  chamomile tea
  a mirror

>w
Tree-lined Path
A silent path. A few owls sit on the birch trees leading to the town square. The ceiling you've seen in the town square is nowhere to be seen, a thick white blanket covering the sky instead.

* * *

>take purse
You take the purse.

* * *

>check attack
Your attack stat is 12.

>e
Calm Pond
A small pond, perfectly still. The sky is covered in white, unmoving clouds. There is a wooden platform next to the north of here. You see a young man sitting on said platform in the distance.

* * *

>ask lotty about dragon
Lotty: The dragon sleeps at the bottom of the clock tower and needs only a swing of its wings to climb the tower.
Lotty: But in the off chance that it attacks you... Maybe this will help!
Lotty produces an omelette out of her basket and shoves it into your hands clumsily.

>tell old lady a joke
I didn't understand that sentence.

>tell joke to old lady
You tell the old lady a knock knock joke, and she bawls from laughter. As reward, you're given a cookie from her basket.

>tell joke to lotty
Lotty laughs at your joke. Finally, someone who gets it!

>e
Clock Tower
An ancient clock tower, made with brown stone and covered in ivies that climbed its walls for ages. Its tower reaches well into the man-made ceiling, the tip of it nearly touching the yellow drawing of the inexistant moon of this world. The hands of time seem to flow seamlessly into the wrong side. As you enter the building, you're met with an owl guard whose head turns into your diretion as your first footsteps echo through the marble-covered floor. To the north, you see a staircase that leads up the slim tower, seemingly leading into a circle as you climb the building. To the east, there is a dark entrance, something shining gleaming from behind it.

You can see Owl here.

* * *

>temporal hoot
The owl's eyes widen and it hoots.

>check gems
You currently have 60 gems.

>inventory
You are carrying:
  a cookie
  an omelette
  chamomile tea
  a mirror

>n
The owl lets you through.

Bell Tower
The climb up the stairs is arduous and dizzying. Something doesn't feel quite right as you ascend the endless tower. But then you exit, and a gust of harsh wind blows into your face. You find yourself at the top of the tower, right below the glowing painted moon. In front of you, there is a giant bell, filled with ancient reliefs and jewels, just ready to be rung. A fierce dragon stands in front of it protectively, asserting your intentions.

* * *

>ring bell
The dragon suddely attacked! You have to defeat it before you can ring the bell! You can either attack, defend from dragon, or use consumables!

>attack
What do you want to attack?

>dragon
You swing at the dragon with all your might! The dragon takes 17 damage!

DRAGON'S TURN
The dragon swings its claws at you! You lost 5 HP!

>attack dragon
You swing at the dragon with all your might! The dragon takes 17 damage!

DRAGON'S TURN
The dragon blows fire! You lost 10 HP!

>check hp
You currently have 15 HP.

>attack dragon
You swing at the dragon with all your might! The dragon takes 17 damage!

DRAGON'S TURN
The dragon has to recharge and does nothing this turn.

>check hp
You currently have 15 HP.

* * *

>attack dragon
You swing at the dragon with all your might! The dragon takes 17 damage!

DRAGON'S TURN
The dragon swings its claws at you! You lost 5 HP!

>check hp
You currently have 10 HP.

>eat omellette
You can't see any such thing.

>eat omelette
You ate the omelette. HP up!

DRAGON'S TURN
The dragon has to recharge and does nothing this turn.

>check hp
You currently have 30 HP.

>attack dragon
You swing at the dragon with all your might! The dragon takes 17 damage!

DRAGON'S TURN
The dragon heals its wounds. It regained 5 HP!

>attack dragon
You swing at the dragon with all your might! The dragon takes 17 damage!
The dragon is defeated! It bows to you and clears the way to the bell.

* * *

>e
End of All
Your footsteps echo through the small wooden path as if the floor was made of marble instead of leaves. The world around you is starting to feel more and more like a dream, but your tired legs seem to suggest otherwise. There are knights in old black armor standing in front of a giant golden door. The imposing nature of the sight makes you realize this could be the end of the journey.

You can see a golden door, Left Knight and Right Knight here.

>unlock golden door with shiny key
You unlock the golden door.

>e
(first opening the golden door)

Fishtank
As you enter the last room, the thing that catches your eyes first is the giant goldfish with a red spot on its forehead, slowly floating in a waterless room as it directs its large eyes towards you. The fish - queen - stares at you for a long time, as if waiting for you to do something.

You can see a golden door and Goldfish here.

>look at fish
You can't see any such thing.

>look at goldfish
The fish - wish queen. A giant goldfish with a red spot on its forehead. Its eyes are goggly. It's floating about in the air-filled room as if swimming in water. You've seen your fair share of world-defying creatures here, so you're not surprised. You're surprised their Majesty the queen is actually just a fish!

>ask goldfish why you are here
I didn't understand that sentence.

>ask goldfish about why you are here
Goldfish:  I'm a magical being, a goldfish. You were brought here by your own will. I fulfill wishes of poeple when I see fit.

>ask goldfish about what happened
Goldfish: I cannot say what happened to you. If you don't remember core memories on your own, it would only shatter your memory. You would wander the world of dreams aimlessly I'm afraid.

>ask goldfish about this place
Goldfish:  The World of Wishes. I've created it a long time ago, for creatures of all worlds to coexist. Those who have strong wishes that would otherwise never be fulfilled land here upon my mercy.

>ask goldfish about wish
Goldfish:  You've proven you're strong and capable to come this far. I grant you one other wish - and that is to stay, or to leave. 
If you leave, you will not be able to continue living in this world, and everyone you've met here will forget of your existence. Such are the rules of this world. You will, however, return home, to your world, stronger and wiser, and will be able to rethink your journey to the sea. 
If you wish to stay, however, you will never again be able to return to the real world, but you will be able to stay here, with everyone you've met, all of your memories intact and safe. You might even choose to live life differently, here.
When you are ready, come here, and simply say "I wish to leave", or "I wish to stay". Nevertheless, your adventure will come to an end.

>ask goldfish about why she saved me
Goldfish: You lowered me back into the water with such care... I could have never left you in that storm even if that weren't the case.

>i wish to leave
You wake up the next morning in your tiny old room, confused as to what has transpired. Your heart is pounding against your chest, and you slowly get out of your bed to turn on the lamp. Everything remains the same as the night you decided to go out to sea. You think back on the goldfish's words and head back to bed, knowing your worth. 
Thank you for playing! - E.K.

>w
End of All
Your footsteps echo through the small wooden path as if the floor was made of marble instead of leaves. The world around you is starting to feel more and more like a dream, but your tired legs seem to suggest otherwise. There are knights in old black armor standing in front of a giant golden door. The imposing nature of the sight makes you realize this could be the end of the journey.

You can see a golden door, Left Knight and Right Knight here.

* * *

>w
Diverging path
As you move deeper into the forest, you can see a tree-lined path that splits left and right. There is a carving in the middle of a giant tree, barely noticeable.

>s
You can't go that way.

* * *

>e
Clock Tower
An ancient clock tower, made with brown stone and covered in ivies that climbed its walls for ages. Its tower reaches well into the man-made ceiling, the tip of it nearly touching the yellow drawing of the inexistant moon of this world. The hands of time seem to flow seamlessly into the wrong side. As you enter the building, you're met with an owl guard whose head turns into your diretion as your first footsteps echo through the marble-covered floor. To the north, you see a staircase that leads up the slim tower, seemingly leading into a circle as you climb the building. To the east, there is a dark entrance, something shining gleaming from behind it.

You can see Owl here.

* * *

>n
The owl lets you through.

Bell Tower
The climb up the stairs is arduous and dizzying. Something doesn't feel quite right as you ascend the endless tower. But then you exit, and a gust of harsh wind blows into your face. You find yourself at the top of the tower, right below the glowing painted moon. In front of you, there is a giant bell, filled with ancient reliefs and jewels, just ready to be rung. A fierce dragon stands in front of it protectively, asserting your intentions.

>attack dragon
You swing at the dragon with all your might! The dragon takes 17 damage!
The dragon is defeated! It bows to you and clears the way to the bell.

>defend from dragon
You defend from the dragon's next attack. You gain temporary 5 defense!

DRAGON'S TURN
The dragon heals its wounds. It regained 5 HP!

* * *

>w
Dreams
You find yourself in another clearing of the forest, but the trees around you appear to be violet in color. There is a clear stream in the middle of the clearing through which busy colorful fish swim. Small dragonflowers swaying in the trees emit a gentle light.

You can see Weeping Blue and a horned rabbit here.

>n
You can't go that way.

>n
You can't go that way.

* * *

>n
Treestump
A large treestump is lying vertically on the ground of the clearing. A few toadstools sit around it, acting as lamps.

You can see a flashlight, a mirror and a fishhook here.

>take mirror
Upon taking the cracked mirror, the other items magically disappear... You decide to go back.

Clearing
It's dark and foggy, so you don't see much. There's dark grass bluish in color from the light emitted by the few fireflies swirling around you. Trees as far and wide as the eye can see.

You can see an old sign here.

>take old sign
Taken.

>s
Diverging path
As you move deeper into the forest, you can see a tree-lined path that splits left and right. There is a carving in the middle of a giant tree, barely noticeable.

* * *

>e
Diverging path
As you move deeper into the forest, you can see a tree-lined path that splits left and right. There is a carving in the middle of a giant tree, barely noticeable.

>n
Clearing
It's dark and foggy, so you don't see much. There's dark grass bluish in color from the light emitted by the few fireflies swirling around you. Trees as far and wide as the eye can see.

>e
Hidden Cave
A small dark cave. You hear drops of water slowly fall to the watery ground beneath you. It's surprisingly cold for such a small space.

You can see a duck here.

* * *

>take duck
The duck eyes the cookie you're carrying hungrily. You prepare to feed the bird, but it lunges at you and steals the cookie. You got the duck, but lost the cookie in the process.

>s
You can't go that way.

>w
Clearing
It's dark and foggy, so you don't see much. There's dark grass bluish in color from the light emitted by the few fireflies swirling around you. Trees as far and wide as the eye can see.

>s
Diverging path
As you move deeper into the forest, you can see a tree-lined path that splits left and right. There is a carving in the middle of a giant tree, barely noticeable.

* * *

>w
Tree-lined Path
A silent path. A few owls sit on the birch trees leading to the town square. The ceiling you've seen in the town square is nowhere to be seen, a thick white blanket covering the sky instead.

* * *

>w
You can't go that way.

>take chamomile
Taken.

>give chamomile to ginny
Ginny: No, thank you. I still have so much to learn and... I must prove myself.
Ginny's words echo through you. Something about them feels so familiar... You want to remember. You feel a surge of power! Defense rose by 3!

>remember
You're still getting dizzy as you try to remember. There was a storm. You're sure of it.

>ask lars about making tea
Lars: Here you go.
Obtained hot tea.

* * *

>ask murmur about how his father got here
There is no reply.

>ask murmur about how his father came here
He went... fishing one day. Then disappeared. It was just me and my father, back then. When he didn't come back, I...
He winces.
I found his straw hat the same day, near the lake where he would fish every day. But there was no sign of him. For a year. He always wished for a change... I gave up evetually. Just continued fishing by the lake.
Your head starts to hurt. You want to remember... You feel a surge of power! Increased attack by 2.

* * *

>e
You can't go that way.

>w
You can't go that way.

>s
Calm Pond
A small pond, perfectly still. The sky is covered in white, unmoving clouds. There is a wooden platform next to the north of here. You see a young man sitting on said platform in the distance.

* * *

>give purse to large bear
The bear seems ecstatic! It lurches forward, grabs the purse from your hands and swings it over its shoulder. She bats her eyelashes at you. She politely reaches into her purse to - somehow - pull out a diamond sword.
Equipping the diamond sword, your attack rose!

>e
Calm Pond
A small pond, perfectly still. The sky is covered in white, unmoving clouds. There is a wooden platform next to the north of here. You see a young man sitting on said platform in the distance.

* * *

>n
The owl lets you through.

Bell Tower
The climb up the stairs is arduous and dizzying. Something doesn't feel quite right as you ascend the endless tower. But then you exit, and a gust of harsh wind blows into your face. You find yourself at the top of the tower, right below the glowing painted moon. In front of you, there is a giant bell, filled with ancient reliefs and jewels, just ready to be rung. A fierce dragon stands in front of it protectively, asserting your intentions.

>check hp
You currently have 30 HP.

>inventory
You are carrying:
  chamomile tea
  a duck
  an old sign
  a mirror

>w
You can't go that way.

>s
Clock Tower
An ancient clock tower, made with brown stone and covered in ivies that climbed its walls for ages. Its tower reaches well into the man-made ceiling, the tip of it nearly touching the yellow drawing of the inexistant moon of this world. The hands of time seem to flow seamlessly into the wrong side. As you enter the building, you're met with an owl guard whose head turns into your diretion as your first footsteps echo through the marble-covered floor. To the north, you see a staircase that leads up the slim tower, seemingly leading into a circle as you climb the building. To the east, there is a dark entrance, something shining gleaming from behind it.

You can see Owl here.

* * *

>w
Tree-lined Path
A silent path. A few owls sit on the birch trees leading to the town square. The ceiling you've seen in the town square is nowhere to be seen, a thick white blanket covering the sky instead.

* * *

>w
Calm Pond
A small pond, perfectly still. The sky is covered in white, unmoving clouds. There is a wooden platform next to the north of here. You see a young man sitting on said platform in the distance.

>e
Tree-lined Path
A silent path. A few owls sit on the birch trees leading to the town square. The ceiling you've seen in the town square is nowhere to be seen, a thick white blanket covering the sky instead.

* * *

>give duck to lotty
Lotty: Thank you so much! I've missed you so much...
Lotty hugs the duck close to her chest.
Lotty: Give this to my brother. I'm sure he will warm up to you.
You got a golden egg.

>w
Tree-lined Path
A silent path. A few owls sit on the birch trees leading to the town square. The ceiling you've seen in the town square is nowhere to be seen, a thick white blanket covering the sky instead.

* * *

>w
Tavern
A lively place. A live band is performing is in the back, and dozens of people are gathered at tiny coffee tables, enjoying hot beverages.

You can see a black tea, a slippery elm tea, Lars, Snowman, Dan, Ginny, Bugcatcher and Schoolteacher here.

>n
You don't have permission to enter.

>give golden egg to lars
Lars: So you've helped my sister, ey. In that case, you can go to the cellar north of here. There might be something in it for you.

* * *

>n
Cellar RM0
A completely dark room with not an ounce of light if not for the lightbulb at the entrance. Your cellar starting point. There's a strong smell of moisture in the air, and you hear trickling of water from above. You can't see much.

>r
That's not a verb I recognise.

>n
Cellar RM3
A completely dark room, same as the rest. There's a strong smell of moisture in the air, and you hear trickling of water from above. You can't see much.

>n
You can't go that way.

>r
That's not a verb I recognise.

>n
You can't go that way.

>e
Cellar RM4
A completely dark room, same as the rest. There's a strong smell of moisture in the air, and you hear trickling of water from above. You can't see much.

>n
Cellar RM5
A small room with a lightbulb attached to the ceiling, making the room somewhat visible. This room leads to no new rooms; you can exit to the south.

You can see a cardboard box (in which is a revive) here.

* * *

>s
Cellar RM4
A completely dark room, same as the rest. There's a strong smell of moisture in the air, and you hear trickling of water from above. You can't see much.

>e
Cellar RM6
A completely dark room, same as the rest. There's a strong smell of moisture in the air, and you hear trickling of water from above. You can't see much.

* * *

>take teleportation charm
Taken.

>teleport
You use the charm to teleport yourself.

Clearing
It's dark and foggy, so you don't see much. There's dark grass bluish in color from the light emitted by the few fireflies swirling around you. Trees as far and wide as the eye can see.

>s
Diverging path
As you move deeper into the forest, you can see a tree-lined path that splits left and right. There is a carving in the middle of a giant tree, barely noticeable.

>s
You can't go that way.

* * *

>n
The owl lets you through.

Bell Tower
The climb up the stairs is arduous and dizzying. Something doesn't feel quite right as you ascend the endless tower. But then you exit, and a gust of harsh wind blows into your face. You find yourself at the top of the tower, right below the glowing painted moon. In front of you, there is a giant bell, filled with ancient reliefs and jewels, just ready to be rung. A fierce dragon stands in front of it protectively, asserting your intentions.

>inventory
You are carrying:
  a teleportation charm
  a revive
  a golden egg
  chamomile tea
  an old sign
  a mirror

>check defense
Your defense stat is 3.

>check attack
Your attack stat is 12.

>ring bell
The dragon suddely attacked! You have to defeat it before you can ring the bell! You can either attack, defend from dragon, or use consumables!

* * *

>attack
What do you want to attack?

>dragon
You swing at the dragon with all your might! The dragon takes 17 damage!

DRAGON'S TURN
The dragon has to recharge and does nothing this turn.

>check hp
You currently have 30 HP.

>attack
What do you want to attack?

>dragon
You swing at the dragon with all your might! The dragon takes 17 damage!

DRAGON'S TURN
The dragon blows fire! You lost 12 HP!

>attack dragon
You swing at the dragon with all your might! The dragon takes 17 damage!

DRAGON'S TURN
The dragon has to recharge and does nothing this turn.

>defende
That's not a verb I recognise.

>defend from draon
You can't see any such thing.

>defend from dragon
You defend from the dragon's next attack. You gain temporary 5 defense!

DRAGON'S TURN
The dragon swings its claws at you! You lost 2 HP!

>check hp
You currently have 16 HP.

>defend from dragon
You defend from the dragon's next attack. You gain temporary 5 defense!

DRAGON'S TURN
The dragon swings its claws at you! You lost 2 HP!

>check hp
You currently have 14 HP.

>defend from dragon
You defend from the dragon's next attack. You gain temporary 5 defense!

DRAGON'S TURN
The dragon swings its claws at you! You lost 2 HP!

>defend from dragon
You defend from the dragon's next attack. You gain temporary 5 defense!

DRAGON'S TURN
The dragon heals its wounds. It regained 5 HP!

>attack
What do you want to attack?

>dragon
You swing at the dragon with all your might! The dragon takes 17 damage!
The dragon is defeated! It bows to you and clears the way to the bell.

* * *

>w
Dreams
You find yourself in another clearing of the forest, but the trees around you appear to be violet in color. There is a clear stream in the middle of the clearing through which busy colorful fish swim. Small dragonflowers swaying in the trees emit a gentle light.

You can see Weeping Blue and a horned rabbit here.

>show mirror to weeping blue
You're not carrying one.

I beg your pardon?

>n
You can't go that way.

* * *

>show mirror to weeping blue
You're not carrying one.

>inventory
You are carrying nothing.

>n
You can't go that way.

* * *

>n
Clearing
It's dark, so you don't see much. There's dark grass bluish in color from the light emitted by the few fireflies swirling around you. Trees as far and wide as the eye can see.

You can see an old sign here.

I beg your pardon?

>n
Treestump
A large treestump is lying vertically on the ground of the clearing. A few toadstools sit around it, acting as lamps.

You can see a flashlight, a mirror and a fishhook here.

* * *

>s
You're not sure how to proceed...

>look at lotty
A young girl half your size, dressed in old garbs and neatly-done braids. She's looking rather distressed.

>ask lotty about her
Lotty: Oh, hello, stranger. I'm Lotty, and I work on a duck farm. My ducks all lay golden eggs, so they are really valuable. But truth be told... I've lost one lately. She scurries off on her own sometimes, but I usually find her very quickly. But you see, stranger, she's been with me for so long now, and... I'm sorry. I don't want to bother you. But if you happen to come across my duck, I'd be very grateful if you brought it back.

I beg your pardon?

>ask lotty about duck
Lotty: My duck likes food above all else. Why, if you happen to have some, she'll immediately want to be picked up!

>ask lotty about this place
Lotty: It's beautiful, isn't it? I go to clock tower east from here sometimes to ring the bell. Anyone can do it. It's a soothing sound.

>ask lotty about dragon
Lotty: You've come across the dragon?
Lotty: Maybe this will help...

>inventory
You are carrying:
  an omelette

>check hp
You currently have 30 HP.

>inventory
You are carrying:
  an omelette

* * *

>inventory
You are carrying:
  an omelette

>ask lotty about dragon
Lotty: You've come across the dragon?
Lotty: Cooking is something I really enjoy. But I only had one with me today. Sorry!

* * *

>inventory
You are carrying:
  a duck

* * *

>s
You're not sure how to proceed...

>take purse
Before you could pick up the purse, the gentleman wearing that ridiculously large tophat you saw at the entrance stops you and bows to you.
Gentleman: What are you doing, young sir? You are in no way entitled to this woman's purse. Run along, now.
You decide to leave the purse where it is.

>look at purse
A fancy hot pink purse with a flower pin attached to it. Who could it belong to? What could it contain? The possibilities are endless.

* * *

>w
Yard
A small yard leading to a cozy wooden tavern just west of here.

You can see Large Bear here.

>w
Tavern
A lively place. A live band is performing is in the back, and dozens of people are gathered at tiny coffee tables, enjoying hot beverages.

You can see a black tea, chamomile tea, a slippey elm tea, Lars, Snowman, Dan, Ginny, Bugcatcher and Schoolteacher here.

>look at black tea
Black tea. Black in color. Smells nice.

>look at chamomile tea
Tea with the smell of a grassy field. Reminds you of home.

>look at slippery elm tea
You can't see any such thing.

>ask lars about slippery elm tea
Lars: It's to soothe the throat.

* * *

>temporal hoot
The owl's eyes widen and it hoots. The clock behind it shows time ticking in the right direction again.

>e
The owl's feathers ruffle, but it remains still.

Treasury
A large open room filled with the brim with gold coins and gems. A large dragon sleeps on top of it all, snoring contently. There's a worn sign here.

* * *

>w
Town Square
A large clearing in the forest populated by dozens of wooden houses giving off a cozy feeling. There's solid ground underneath your feet, and a large ceiling above your head. You can't make out the material it's made out of. There's large streetlamps to illuminate the path and a large fountain of clear water in the middle. Children are dnacing in a circle in the bag, a cat is meowing from a roof. People walk around, chat, look at you as you stand at the entrance. An imposing clock tower can be seen from the distance, almost reaching the white round drawing of a moon. The smell of wood and bakeries is overwhelming.

You can see Old lady, Gentleman, Lotty, Nutcracker, Fisherman, Polly and a purse here.

* * *

>s
Diverging path
As you move deeper into the forest, you can see a tree-lined path that splits left and right. There is a carving in the middle of a giant tree, barely noticeable.

>e
End of All
Your footsteps echo through the small wooden path as if the floor was made of marble instead of leaves. The world around you is starting to feel more and more like a dream, but your tired legs seem to suggest otherwise. There are knights in old black armor standing in front of a giant golden door. The imposing nature of the sight makes you realize this could be the end of the journey.

You can see a golden door, Left Knight and Right Knight here.

>w
Diverging path
As you move deeper into the forest, you can see a tree-lined path that splits left and right. There is a carving in the middle of a giant tree, barely noticeable.

>catch horned rabbit
You run after the horned rabbit and it starts fleeing. You follow the rabbit out of the clearing, landing in a new area.

Town Square
You can see Old lady, Gentleman, Curious boy, Nutcracker, Polly and a purse here.

>go n
Dreams
You find yourself in another clearing of the forest, but the trees around you appear to be violet in color. There is a clear stream in the middle of the clearing through which busy colorful fish swim. Small dragonflowers swaying in the trees emit a gentle light.

You can see Weeping Blue and a horned rabbit here.

>s
Town Square
You can see Old lady, Gentleman, Curious boy, Nutcracker, Polly and a purse here.

>take purse
Before you could pick up the purse, the gentleman wearing that ridiculously large tophat you saw at the entrance stops you and bows to you.
Gentleman: What are you doing, young sir? You are in no way entitled to this woman's purse. Run along, now.
You decide to leave the purse where it is.

>inventory
You are carrying nothing.

>look at welcome sign
"Welcome to the World of Wishes", the sign reads.

* * *

>temporal hoot
The owl's eyes widen and it hoots.

>w
Town Square
A large clearing in the forest populated by dozens of wooden houses giving off a cozy feeling. There's solid ground underneath your feet, and a large ceiling above your head. You can't make out the material it's made out of. There's large streetlamps to illuminate the path and a large fountain of clear water in the middle. Children are dnacing in a circle in the bag, a cat is meowing from a roof. People walk around, chat, look at you as you stand at the entrance. An imposing clock tower can be seen from the distance, almost reaching the white round drawing of a moon. The smell of wood and bakeries is overwhelming.

You can see Old lady, Gentleman, Lotty, Nutcracker, Fisherman, Polly and a purse here.

* * *

>e
The owl's feathers ruffle, but it remains still.

Treasury
A large open room filled with the brim with gold coins and gems. A monster sleeps on top of it all, snoring contently. There's a worn sign here.

>look at worn sign
You can't see any such thing.

* * *

>e
End of All
Your footsteps echo through the small wooden path as if the floor was made of marble instead of leaves. The world around you is starting to feel more and more like a dream, but your tired legs seem to suggest otherwise. There are knights in old black armor standing in front of a giant golden door. The imposing nature of the sight makes you realize this could be the end of the journey.

You can see a golden door, Left Knight and Right Knight here.

>look at right knight
Upon further inspection, the knight isn't actually a knight - it's  just armor and is perfectly still. But something seems to be sticking out of this knight's helmet...

>look at left knight
Upon further inspection, the knight isn't actually a knight - it's  just armor and is perfectly still.

>w
Diverging path
As you move deeper into the forest, you can see a tree-lined path that splits left and right. There is a carving in the middle of a giant tree, barely noticeable.

* * *

>take duck
The duck eyes the cookie you're carrying hungrily. You prepare to feed the bird, but it lunges at you and steals the cookie. You got the duck, but lost the cookie in the process.

>e
Clearing
It's dark and foggy, so you don't see much. There's dark grass bluish in color from the light emitted by the few fireflies swirling around you. Trees as far and wide as the eye can see.

You can see an old sign here.

>s
Diverging path
As you move deeper into the forest, you can see a tree-lined path that splits left and right. There is a carving in the middle of a giant tree, barely noticeable.

* * *

>look at lotty
A young girl half your size but around your age, dressed in old garbs and neatly-done braids. She's looking rather distressed.

>ask lotty about her
Lotty: Oh, hello, stranger. I'm Lotty, and I work on a duck farm. My ducks all lay golden eggs, so they are really valuable. But truth be told... I've lost one. She scurries off on her own sometimes, but I usually find her very quickly. But you see, stranger, she's been with me for so long now, and... I'm sorry. I don't want to bother you. But if you happen to come across my duck, I'd be very grateful if you brought it back.

>ask lotty about duck
Lotty: My duck likes food above all else. Why, if you happen to have some, she'll immediately want to be picked up! Oh - all but meat and eggs...

>give duck to lotty
Lotty: Thank you so much! I've missed you so much...
Lotty hugs the duck close to her chest.
Lotty: Give this to my brother. I'm sure he will warm up to you.
You got a golden egg.

>look at lotty
A young girl half your size but around your age, dressed in old garbs and neatly-done braids. She's holding her prized white duck happily and waves at you.

>give duck to lotty
You can't see any such thing.

>give duck to lotty
You can't see any such thing.

>ask lotty about duck
Lotty: My duck likes food above all else. Why, if you happen to have some, she'll immediately want to be picked up! Oh - all but meat and eggs...

>ask lotty about her
Lotty: Oh, hello, Stef! How's it going! My duck and I are enjoying our free time right now.

* * *

>e
End of All
Your footsteps echo through the small wooden path as if the floor was made of marble instead of leaves. The world around you is starting to feel more and more like a dream, but your tired legs seem to suggest otherwise. There are knights in old black armor standing in front of a giant golden door. The imposing nature of the sight makes you realize this could be the end of the journey.

You can see a golden door, Left Knight and Right Knight here.

>look at golden door
The door in front of you is imposing and heavy. Even if you try to push with all your might, you don't think you'll succeed in opening it.

* * *

>e
(first opening the golden door)
It seems to be locked.

>demand from right knight to open door
The knight refuses to move and ignores you. But this knight is nice, so you feel bad for raising your voice. You gently leave behind 50 gems.

>check gems
You currently have -50 gems.
You guess it's been put on a tab now.

>w
Diverging path
As you move deeper into the forest, you can see a tree-lined path that splits left and right. There is a carving in the middle of a giant tree, barely noticeable.

>n
Clearing
It's dark and foggy, so you don't see much. There's dark grass bluish in color from the light emitted by the few fireflies swirling around you. Trees as far and wide as the eye can see.

You can see an old sign here.

* * *

>take mirror
Upon taking the cracked mirror, the other items magically disappear... You decide to go back.

Clearing
It's dark and foggy, so you don't see much. There's dark grass bluish in color from the light emitted by the few fireflies swirling around you. Trees as far and wide as the eye can see.

You can see an old sign here.

>s
Diverging path
As you move deeper into the forest, you can see a tree-lined path that splits left and right. There is a carving in the middle of a giant tree, barely noticeable.

* * *

>show mirror to weeping blue
Weeping Blue takes the cracked mirror from your hands and looks at herself. She suddenly smiles a brilliant smile.
Thank you very much, boy. I finally remember. now I hope my necklace helps you in some way.
In the back, the horned rabbit's eyes shine.

>inventory
You are carrying:
  a crystal teardrop
  a mirror

>pet horned rabbit
You pet the horned rabbit. Its fur is very soft and fluffy.

* * *

>look at orned rabbit
You can't see any such thing.

>look at horned rabbit
A white horned rabbit, curiously looking your way. No matter what you do, it seems intent on following. Try approaching it!

* * *

>check gems
You currently have 0 gems.

>play rock for polly
ROCK!
Polly: Draw!

* * *

>play rock for polly
SCISSORS!
Polly: I lost?!
Polly gives you a gem.

>check gems
You currently have 1 gems.

* * *

>s
Diverging path
As you move deeper into the forest, you can see a tree-lined path that splits left and right. There is a carving in the middle of a giant tree, barely noticeable.

>look at carving
"Have your dreams come true", is written under the left arrow. A bit optimistic, and since you're not sure yourself whether this location is a dream on its own, you're not too excited. On the other hand, the right sign says "The end of all", which is kind of threatening, and your feet refuse to move.

* * *

>w
Dreams
You find yourself in another clearing of the forest, but the trees around you appear to be violet in color. There is a clear stream in the middle of the clearing through which busy colorful fish swim. Small dragonflowers swaying in the trees emit a gentle light.

You can see Weeping Blue and a horned rabbit here.

>tell joke to weeping blue
Weeping Blue starts to cry again. You made things worse?!

>s
Town Square
You can see Old lady, Gentleman, Curious girl, Nutcracker, Fisherman, Polly and a purse here.

>tell joke to gentleman
He stares at you emotionlessly. You stare back. It's not the most comfortable situation.

>tell joke to old lady
You tell the old lady a knock knock joke, and she bawls from laughter. As reward, you're given a cookie from her basket.

>tell joke to polly
Polly repeats the joke. You realize it sounded funnier in your head.

>s
You can't go that way.

>w
Calm Pond
A small pond, perfectly still. The sky is covered in white, unmoving clouds. There is a wooden platform next to the north of here. You see a young man sitting on said platform in the distance.

You can see a bucket here.

* * *

>n
Wooden Platform
A simple wooden platform for fishermen to sit at and put their belongings on.

You can see Murmur here.

>tell joke to murmur
Murmur offers a weak smile. It's not reassuring.

* * *

>s
Diverging path
As you move deeper into the forest, you can see a tree-lined path that splits left and right. There is a carving in the middle of a giant tree, barely noticeable.

>n
Clearing
It's dark and foggy, so you don't see much. There's dark grass bluish in color from the light emitted by the few fireflies swirling around you. Trees as far and wide as the eye can see.

You can see an old sign here.

* * *

>tell joke to old lady
You tell the old lady a knock knock joke, and she bawls from laughter. As reward, you're given a cookie from her basket.

* * *

>take duck
The duck eyes the cookie you're carrying hungrily. You prepare to feed the bird, but it lunges at you and steals the cookie. You got the duck, but lost the cookie in the process.

>w
Clearing
It's dark and foggy, so you don't see much. There's dark grass bluish in color from the light emitted by the few fireflies swirling around you. Trees as far and wide as the eye can see.

You can see an old sign here.

* * *

>tell joke to old lady
You tell the old lady a knock knock joke, and she bawls from laughter. As reward, you're given a cookie from her basket.

>help fisherman tie hook
You tie the fisherman's hook to the pole with a smile. The fisherman gives you 20 gems as compensation, which you politely decline. But the fisherman stuffs them into your hand nevertheless.

>give duck to lotty
Lotty: Thank you so much! I've missed you so much...
Lotty hugs the duck close to her chest.
Lotty: Give this to my brother. I'm sure he will warm up to you.
You got a golden egg.

* * *

>look at lotty
A young girl half your size but around your age, dressed in old garbs and neatly-done braids. She's holding her prized white duck happily and waves at you.

>ask lotty about dragon
Lotty: The dragon sleeps at the bottom of the clock tower and needs only a swing of its wings to climb the tower.
Lotty: But in the off chance that it attacks you... Maybe this will help!
Lotty produces an omelette out of her basket and shoves it into your hands clumsily.

* * *

>give bucket to murmur
The young man extends his hand to take the item. He nods curtly, then fastens one of the worms to the hook. You'll never like the sight of it.

>ask about how his father came to the world of wishes
You can't see any such thing.

>ask murmur about how his father came to the world of wishes
There is no reply.

>ask murmur about how his father came to world of wishes
He went... fishing one day. Then disappeared. It was just me and my father, back then. When he didn't come back, I...
He winces.
I found his straw hat the same day, near the lake where he would fish every day. But there was no sign of him. For a year. He always wished for a change... I gave up evetually. Just continued fishing by the lake.
Your head starts to hurt. You want to remember... You feel a surge of power! Increased attack by 2.

>remember what happened
I only understood you as far as wanting to remember.

>remember what happened
I only understood you as far as wanting to remember.

>remember
You're still getting dizzy as you try to remember. There was a storm. You're sure of it.

>s
Calm Pond
A small pond, perfectly still. The sky is covered in white, unmoving clouds. There is a wooden platform next to the north of here. You see a young man sitting on said platform in the distance.

>n
Wooden Platform
A simple wooden platform for fishermen to sit at and put their belongings on.

You can see Murmur here.

>play scissors for murmur
ROCK.
Murmur: A win.

* * *

>play scissors for murmur
PAPER.
Murmur: I lose.
Murmur gives you 5 gems as a prize.

>s
Calm Pond
A small pond, perfectly still. The sky is covered in white, unmoving clouds. There is a wooden platform next to the north of here. You see a young man sitting on said platform in the distance.

* * *

>give golden egg to lars
Lars: So you've helped my sister, ey. In that case, you can go to the cellar north of here. There might be something in it for you.

>n
Cellar RM0
A completely dark room with not an ounce of light if not for the lightbulb at the entrance. Your cellar starting point. There's a strong smell of moisture in the air, and you hear trickling of water from above.  There's a path to the north and to the east of here.

>e
Cellar RM1
A completely dark room, same as the rest. There's a strong smell of moisture in the air, and you hear trickling of water from above.  There's a path to the north, west and to the east of here.

>n
Cellar RM4
A completely dark room, same as the rest. There's a strong smell of moisture in the air, and you hear trickling of water from above.  There's a path to the east, west, north and south. You're close to something.

>n
Cellar RM5
A small room with a lightbulb attached to the ceiling, making the room somewhat visible. This room leads to no new rooms; you can exit to the south.

You can see a cardboard box (in which is a revive) here.

* * *

>take revive
Taken.

>s
Cellar RM4
A completely dark room, same as the rest. There's a strong smell of moisture in the air, and you hear trickling of water from above.  There's a path to the east, west, north and south. You're close to something.

>e
Cellar RM6
A completely dark room, same as the rest. There's a strong smell of moisture in the air, and you hear trickling of water from above.  There's a path to the west and north from here. You're close to something!

>n
Cellar RM7
A room lit by a single light bulb hanging from the ceiling. There's a strong smell of moisture in the air, and you hear trickling of water from above. This room smells of tea and condiments.

You can see a metal box (in which is a teleportation charm) here.

* * *

>take teleportation charm
Taken.

>s
Cellar RM6
A completely dark room, same as the rest. There's a strong smell of moisture in the air, and you hear trickling of water from above.  There's a path to the west and north from here. You're close to something!

>w
Cellar RM4
A completely dark room, same as the rest. There's a strong smell of moisture in the air, and you hear trickling of water from above.  There's a path to the east, west, north and south. You're close to something.

>s
Cellar RM1
A completely dark room, same as the rest. There's a strong smell of moisture in the air, and you hear trickling of water from above.  There's a path to the north, west and to the east of here.

>w
Cellar RM0
A completely dark room with not an ounce of light if not for the lightbulb at the entrance. Your cellar starting point. There's a strong smell of moisture in the air, and you hear trickling of water from above.  There's a path to the north and to the east of here.

>s
Tavern
A lively place. A live band is performing is in the back, and dozens of people are gathered at tiny coffee tables, enjoying hot beverages.

You can see a black tea, chamomile tea, a slippery elm tea, Lars, Snowman, Dan, Ginny, Bugcatcher and Schoolteacher here.

>take chamomile tea
Taken.

* * *

>give chamomile tea to ginny
Ginny: No, thank you. I still have so much to learn and... I must prove myself.
Ginny's words echo through you. Something about them feels so familiar... You want to remember. You feel a surge of power! Defense rose by 3!

>e
Yard
A small yard leading to a cozy wooden tavern just west of here.

You can see Large Bear here.

* * *

>look at fish
Very buys-looking red fish. They swim through the stream rather quickly, and you can't make out anything else other than fish. You would jump into water to scare them off, were you not deathly afraid of the fish swimming in the stream in the first place. Something golden shimmers in the water.

>take gold
You can't see any such thing.

>reach for gold
You reach for the golden object shimmering in the stream, but your head suddenly starts to hurt horribly, stopping you in your action.
You want to remember... You feel a surge of energy! Defense increased by 2!

>check defense
Your defense stat is 5.

>check attack
Your attack stat is 7.

>s
Town Square
A large clearing in the forest populated by dozens of wooden houses giving off a cozy feeling. There's solid ground underneath your feet, and a large ceiling above your head. You can't make out the material it's made out of. There's large streetlamps to illuminate the path and a large fountain of clear water in the middle. Children are dnacing in a circle in the bag, a cat is meowing from a roof. People walk around, chat, look at you as you stand at the entrance. An imposing clock tower can be seen from the distance, almost reaching the white round drawing of a moon. The smell of wood and bakeries is overwhelming.

You can see Old lady, Gentleman, Lotty, Nutcracker, Fisherman, Polly and a purse here.

* * *

>w
Tree-lined Path
A silent path. A few owls sit on the birch trees leading to the town square. The ceiling you've seen in the town square is nowhere to be seen, a thick white blanket covering the sky instead.

I beg your pardon?

>w
Calm Pond
A small pond, perfectly still. The sky is covered in white, unmoving clouds. There is a wooden platform next to the north of here. You see a young man sitting on said platform in the distance.

* * *

>give purse to large bear
The bear seems ecstatic! It lurches forward, grabs the purse from your hands and swings it over its shoulder. She bats her eyelashes at you. She politely reaches into her purse to - somehow - pull out a diamond sword.
Equipping the diamond sword, your attack rose!

>check attack
Your attack stat is 17.

>e
Calm Pond
A small pond, perfectly still. The sky is covered in white, unmoving clouds. There is a wooden platform next to the north of here. You see a young man sitting on said platform in the distance.

* * *

>ring bell
The dragon suddely attacked! You have to defeat it before you can ring the bell! You can either attack, defend from dragon, or use consumables!

>inventory
You are carrying:
  a hot tea
  chamomile tea
  a teleportation charm
  a revive
  an omelette
  a golden egg
  a cookie
  a flashlight

>attack
What do you want to attack?

>dragon
You swing at the dragon with all your might! The dragon takes 22 damage!

DRAGON'S TURN
The dragon has to recharge and does nothing this turn.

>attack dragon
You swing at the dragon with all your might! The dragon takes 22 damage!

DRAGON'S TURN
The dragon swings its claws at you! You lost 5 HP!

>check hp
You currently have 25 HP.

>defend
What do you want to defend from?

>from dragon
You can't see any such thing.

>defend from dragon
You defend from the dragon's next attack. You gain temporary 5 defense!

DRAGON'S TURN
The dragon swings its claws at you! You lost 0 HP!

>attack dragon
You swing at the dragon with all your might! The dragon takes 22 damage!
The dragon is defeated! It bows to you and clears the way to the bell.

>ring bell
The dragon bows its head.
You rang the bell. It's soothing sound echoes through the area... Oh? But what's this? Something seems to have fallen out of it as you rung it.
You obtained the shiny key!

* * *

>catch horned rabbit
You can't see any such thing.

>check gems
You currently have 0 gems.

* * *

>hookTied
That's not a verb I recognise.

* * *

>inventory
You are carrying nothing.

>w
Hidden Cave
A small dark cave. You hear drops of water slowly fall to the watery ground beneath you. It's surprisingly cold for such a small space.

You can see a duck here.

>take duck
The duck won't move from its spot. It hisses at you.

* * *

>s
Town Square
You can see Old lady, Gentleman, Curious girl, Nutcracker, Fisherman, Polly and a purse here.

>tell joke to old ldy
You can't see any such thing.

>tell joke to old lady
You can't see any such thing.

>tell a joke to old lady
Old lady who

>inventory
You are carrying:
  a cookie

* * *

>w
You can't go that way.

>e
First path
As you move deeper into the forest, you can see a tree-lined path that splits left and right. There is a carving in the middle of a giant tree, barely noticeable.

* * *

>take duck
The duck eyes the bread hungrily. You prepare to feed the bird, but it lunges at you and steals the bread. You got the duck, but lost the breadloaf in the process.

>look at cookie
You can't see any such thing.

* * *

>look at cookie
You can't see any such thing.

>s
First path
As you move deeper into the forest, you can see a tree-lined path that splits left and right. There is a carving in the middle of a giant tree, barely noticeable.

* * *

>s
Town Square
You can see Old lady, Gentleman, Curious girl, Nutcracker, Fisherman, Polly and a purse here.

>tell joke to old lady
You can't see any such thing.

>tell a joke to old lady
You tell the old lady a knock knock joke, and she bawls from laughter. As reward, you're given a cookie from her basket.

>inventory
You are carrying:
  a cookie

>tell a joke to old lady
You tell the old lady a knock knock joke, and she bawls from laughter.

>inventory
You are carrying:
  a cookie

* * *

>check hp
You currently have 30 HP.

>s
First path
As you move deeper into the forest, you can see a tree-lined path that splits left and right. There is a carving in the middle of a giant tree, barely noticeable.

* * *

>tell joke to old lady
You tell the old lady a knock knock joke, and she bawls from laughter. As reward, you're given a cookie from her basket.

>eat cookie
You ate the cookie. HP up!

* * *

>check hp
You currently have 30 HP.

>inventory
You are carrying:
  a cookie

* * *

>puh sign
That's not a verb I recognise.

* * *

>e
Hidden Cave
A small dark cave. You hear drops of water slowly fall to the watery ground beneath you. It's surprisingly cold for such a small space.

You can see a duck here.

>take duck
The duck won't move from its spot. It hisses at you.

>catch duck
You want to take the duck by force, so the duck uses its force back.
You lost 10 HP!

>catch duck
You want to take the duck by force, so the duck uses its force back.
You lost 10 HP!

>check hp
You currently have 10 HP.

>catch duck
You want to take the duck by force, so the duck uses its force back.
You lost 10 HP!

    *** You've lost all your HP! You're unable to continue your journey. ***

Would you like to RESTART, RESTORE a saved game, QUIT or UNDO the last command?

>undo
Hidden Cave
[Previous turn undone.]

>check hp
You currently have 10 HP.

* * *

>check defense
Your defense stat is 2.

>e
Hidden Cave
A small dark cave. You hear drops of water slowly fall to the watery ground beneath you. It's surprisingly cold for such a small space.

You can see a duck here.

>catch duck
You want to take the duck by force, so the duck uses its force back.
You lost 8 HP!

>check hp
You currently have 22 HP.

>catch duck
You want to take the duck by force, so the duck uses its force back.
You lost 8 HP!

>catch duck
You want to take the duck by force, so the duck uses its force back.
You lost 8 HP!

>catch duck
You want to take the duck by force, so the duck uses its force back.
You lost 8 HP!

    *** You've lost all your HP! You're unable to continue your journey. ***

Would you like to RESTART, RESTORE a saved game, QUIT or UNDO the last command?

>undo
Hidden Cave
[Previous turn undone.]

>check hp
You currently have 6 HP.

>catch duck
You want to take the duck by force, so the duck uses its force back.
You lost 8 HP!

    *** You've lost all your HP! You're unable to continue your journey. ***

Would you like to RESTART, RESTORE a saved game, QUIT or UNDO the last command?

>restart
"Welcome to the world of wishes", an ominous voice calls from afar. You stirr in your sleep and wake up, only to find yourself on cold grass - you don't remember falling asleep here. You look around you, only to realize you are in the midst of a forest clearing. It's horribly foggy, but strangely warm.

WishFish
An Interactive Fiction by Elena Krzina
Release 1 / Serial number 221230 / Inform 7 build 6M62 (I6/v6.33 lib 6/12N) SD

Clearing
It's dark and foggy, so you don't see much. There's dark grass bluish in color from the light emitted by the few fireflies swirling around you. Trees as far and wide as the eye can see.

You can see an old sign here.

* * *

>temporal hoot
You say to yourself.

>s
Diverging path
As you move deeper into the forest, you can see a tree-lined path that splits left and right. There is a carving in the middle of a giant tree, barely noticeable.

* * *

>e
Clock Tower
An ancient clock tower, made with brown stone and covered in ivies that climbed its walls for ages. Its tower reaches well into the man-made ceiling, the tip of it nearly touching the yellow drawing of the inexistant moon of this world. The hands of time seem to flow seamlessly into the wrong side. As you enter the building, you're met with an owl guard whose head turns into your diretion as your first footsteps echo through the marble-covered floor. To the west, you see a staircase that leads up the slim tower, seemingly leading into a circle as you climb the building. To the east, there is a dark entrance, something shining gleaming from behind it.

You can see Owl here.

>temporal hoot
The owl's eyes widen and it hoots. The clock behind it shows time ticking in the reight direction again.

* * *

>deposit gems
you don't know where to deposit the gems. Is there a bank here?

>s
Diverging path
As you move deeper into the forest, you can see a tree-lined path that splits left and right. There is a carving in the middle of a giant tree, barely noticeable.

* * *

>temporal hoot
The owl's eyes widen and it hoots. The clock behind it shows time ticking in the reight direction again.

>go east
Treasury
A large open room filled with the brim with gold coins and gems. A large dragon sleeps on top of it all, snoring contently. There's a worn sign here.

>deposit gems
You don't think that'll be enough.

* * *

>i wish to leave
*** You wake up the next morning in your tiny old room, confused as to what has transpired. Your heart is pounding against your chest, and you slowly get out of your bed to turn on the lamp. Everything remains the same as the night you decided to go out to sea. You think back on the goldfish's words and head back to bed, knowing your worth. 
Thank you for playing! - E.K. ***

Would you like to RESTART, RESTORE a saved game, QUIT or UNDO the last command?

* * *

>n
Treestump
A large treestump is lying vertically on the ground of the clearing. A few toadstools sit around it, acting as lamps.

You can see a flashlight, a mirror and a fishhook here.

* * *

>show mirror to weeping blue
Weeping Blue takes the cracked mirror from your hands and looks at herself. She suddenly smiles a brilliant smile.
Thank you very much, boy. I finally remember how I look like.
In the back, the horned rabbit's eyes shine.

>approach rabbot
You can't see any such thing.

>approach rabbit
The rabbit seems pleased with you that you've taken the time to help the woman out of her troubles. He wants you to follow him south, while shaking 50 gems out of its furr. You obtain the gems, and follow him wordlessly.

Town Square
A large clearing in the forest populated by dozens of wooden houses giving off a cozy feeling. There's solid ground underneath your feet, and a large ceiling above your head. You can't make out the material it's made out of. There's large streetlamps to illuminate the path and a large fountain of clear water in the middle. Children are dnacing in a circle in the bag, a cat is meowing from a roof. People walk around, chat, look at you as you stand at the entrance. An imposing clock tower can be seen from the distance, almost reaching the yellow round drawing of a moon. The smell of wood and bakeries is overwhelming.

You can see Old lady, Gentleman, Lotty, Nutcracker, Fisherman, Polly and a purse here.

* * *

>n
Wooden Platform
A simple wooden platform for fishermen to sit at and put their belongings on.

You can see Murmur here.

>play rock for murmur
SCISSORS.
Murmur: I lose.
Murmur gives you 5 gems as a prize.

* * *

>e
Calm Pond
A small pond, perfectly still. The sky is covered in white, unmoving clouds. There is a wooden platform next to the north of here. You see a young man sitting on said platform in the distance.

>w
Yard
A small yard leading to a cozy wooden tavern just west of here.

You can see Large Bear here.

>s
You can't go that way.

>e
Calm Pond
A small pond, perfectly still. The sky is covered in white, unmoving clouds. There is a wooden platform next to the north of here. You see a young man sitting on said platform in the distance.

* * *

>take purse
You take the purse.

>look at purse
A fancy hot pink purse with a flower pin attached to it. Who could it belong to? What could it contain? Should you reach into it? The possibilities are endless.

>reach into purse
You reach into the purse. There's 50 gems in it. You take them with you.

>check gems
You currently have 115 gems.

>e
Clock Tower
An ancient clock tower, made with brown stone and covered in ivies that climbed its walls for ages. Its tower reaches well into the man-made ceiling, the tip of it nearly touching the yellow drawing of the inexistant moon of this world. The hands of time seem to flow seamlessly into the wrong side. As you enter the building, you're met with an owl guard whose head turns into your direction as your first footsteps echo through the marble-covered floor. To the north, you see a staircase that leads up the slim tower, seemingly leading into a circle as you climb the building. To the east, there is a dark entrance, something shining gleaming from behind it.

You can see Owl here.

* * *

>e
The owl's feathers ruffle, but it remains still.

Treasury
A large open room filled with the brim with gold coins and gems. A monster sleeps on top of it all, snoring contently. There's a note here.

>look at note
"The dragon blesses those who deposit a large sum of gems. Profits go to dragons. Will be guarded safely for all enternity." Or so the sign says.

>deposit gold
I didn't understand that sentence.

>deposit gems
You deposited 100 gems for dragon profit.